mức tăng hằng_năm không cao	chậm_tăng_lương
good env. for fresher to learn and improve their ability	nhiều_cơ_hội_học_hỏi_và_nâng_cao_khả năng_cho_nhân_viên_chưa_có_kinh_nghiệm
quiet opened and flexible working time	thời_gian_làm_việc_linh_hoạt
depend on teams and lead to provide OT conpensation	có_lương_làm_thêm_giờ tuỳ_vào_đội_nhóm_và_trưởng_nhóm
Need to forcus more on benefit and evaluate contribution of qualified employee	cần_tập_trung_vào_phúc_lợi và cần_tập_trung_đánh_giá_sự đóng_góp_của_nhân_viên_giỏi
Dynamic and young work force	nhân_viên_trẻ_và_năng_động
Great working environment (music band, gym, relax corners, PS4, Baby foot, ping-pong table etc.)	môi_trường_làm_việc_thoải_mái_và_thân_thiện
Allowances (lunch, parking)	phụ_cấp_ăn_trưa có_bãi_đỗ_xe
Travel opportunities (Intersites mobility	có_cơ_hội_du_lịch
Team activities (CSR, team buildings, company trips)	có_hoạt_động_đội_nhóm
Full social insurance, unemployment insurance, health insurance	có_bảo_hiểm_xã_hội có_bảo_hiểm_thất_nghiệp
Personal incident and health insurance	bảo_hiểm_tai_nạn bảo_hiểm_sức_khoẻ
Dynamic and young work force Up to now all of things so far so good and I think nothing to change	
van phong dep	văn_phòng_đẹp
dong nghiep vuive	đồng_nghiệp_thân_thiện
sep than thien	nhà_quản_lý_thân_thiện
cong viec co nhieu cai de hoc hoi	có_cơ_hội_học_hỏi_và_nâng_cao_khả_năng
co team OT nhieu / co team OT it	có_làm_thêm_giờ
Minh thi ko OT nen ko care benefit can cai thien	cần_cải_thiện_phúc_lợi
Process / Operation can cai thien 	cần_cải_thiện_quy_trình_làm_việc
The company has a good work space and working from home policy.	không_gian_làm_việc_đẹp_và_hiện_đại	có_thể_làm_việc_từ_xaß
Good environment for fresher. - The salary is lower than maker salary.	nhiều_cơ_hội_học_hỏi_và_nâng_cao_khả năng	lương_thấp
High workload	khối_lượng_công_việc_nhiều
The company don't have OT policy for project team and a lot of works.	không_có_phụ_cấp_làm_thêm_giờ, khối_lượng_công_việc_nhiều
// I see you’re the first software company in Vietnam that can train a software-student to become international software engineer. It’s not easy career path and it’s not fast, it needs slowly and calm down in some years working focus.	có_cơ_hội_học_hỏi_và_nâng_cao_khả_năng	chương_trình_đào_tạo_nhân_viên_tốt
(Some years ago, 1 company paid me more 50% salary than Adnovum but I’m so lucky to do the right reason is choosing Adnovum to work without care much about the salary because the company will pay not low with your competence. The good salary will come after at least 2 years)	lương_cao
OT will be paid.	có_lương_và_chế_độ_làm_thêm_giờ	
Flexible working time (but should online from 10 - 4) & place (such as you can work from home) Try to keep your feedback culture more often and often. It's very good!	thời_gian_làm_việc_linh_hoạt, có_thể_làm_việc_từ_xa
Notthing	không_có_gì
Company has a good workspace (pantry / kitchen / gaming......)	không_gian_làm_việc_đẹp_và_hiện_đại
You could do a remote job (no need to ask approval if your remote working is few days)	có_thể_làm_việc_từ_xa
Depend on job and chances, you could go to HK/JP/EU for business trip	có_thể_đi_công_tác_nước_ngoài
Cross culture in the company (French / English / Maurice / Chinese/ ...) The worst thing here is about process
they need to improve	quy_trình_làm_việc_tệ, cần_cải_thiện_quy_trình_làm_việc
this topic a lot, and 2nd thing is about salary when you compare with your work load .	lương_thấp
They also need to improve about the training	cần_cải_thiện_vấn_đề_đào_tạo_nhân_viên
Cross culture but strong French culture	văn_hoá_pháp
Technical guys could get the OT easily	nhân_viên_kỹ_thuật_có_lương_làm_thêm_giờ
but not easy for other position	không_có_lương_và_chế_độ_làm_thêm_giờ
van phong thoang mat,	văn_phòng_thoáng_mát
view dep,	không_gian_đẹp_và_hiện_đại
dong nghiep nice, de gan process chua ro rang, nen improve de cong viec troi chay hon quy_trình_làm_việc_tệ, nên_cải_thiện_quy_trình_làm_việc
Good company with interesting projects, and carrer opportunities path. Văn Phòng đẹp, trang thiết bị đầy đủ, văn phòng rộng thoải mái.
Not so many OT, except in critical situation, extra salary for OT cơ hội làm việc với khách hàng và các đối tác nước ngoài
Good company with interesting projects, and carrer opportunities path. dự_án_thú_vị, có_cơ_hội_phát_triển_sự_nghiệp
Not so many OT, except in critical situation, extra salary for OT	ít_khi_làm_thêm_giờ, có_lương_và_chế_độ_làm_thêm_giờ
Đã hết chính sách wfh	không_làm_việc_từ_xa
Môi trường active vs flexible	môi_trường_làm_việc_linh_hoạt,	môi_trường_làm_việc_năng_động
Có thêm nhiều buổi training workshop	cần_có_thêm_nhiều_hội_thảo_đào_tạo
Flexible thời gian làm việc	thời_gian_làm_việc_linh_hoạt
training workshop	hội_thảo_đào_tạo
- Good salary	lương_cao
do performance reviews	xét_tăng_lương
twice a year.	hai_lần_một_năm
and thus I have a good opportunity to move higher up my career path.	có_cơ_hội_phát_triền_nghề_nghiệp
- It's a professional working environment.	môi_trường_làm_việc_chuyên_nghiệp
I work with many senior engineers,	nhiều_nhân_viên_có_kinh_nghiệm
which provides me with chances to learn new great things.	có_cơ_hội_học_hỏi_và_nâng_cao_khả_năng
- Flexible working hours and hybrid work.	thời_gian_làm_việc_linh_hoạ, có_thể_làm_việc_từ_xa
I just have to work at the office once a week or once per two weeks or even once a month.	có_thể_làm_việc_từ_xa
- People in ANDPAD are very supportive,	đồng_nghiệp_hỗ_trợ_lẫn_nhau
even senior staffs such as CEO, CTO.	nhà_quản_lý_hỗ_trợ
I just have to work 8 hours a day and I do not have to work overtime.	không_làm_thêm_giờ
The company offers excellent facilities to support your work. 	trang_thiết_bị_hiện_đại
The majority of employees demonstrate strong ownership, phần_lớn nhân_viên_có_tinh_thần_trách_nhiệm_cao
creating a harmonious and productive work environment.	môi_trường_làm_việc_hiệu_quả
The flexibility of a hybrid working model is a significant advantage.	có_thể_làm_việc_từ_xa
The company does not require overtime.	không_làm_thê_giờ
You are in charge of managing your tasks, and the company respects ownership of your work.	nhân_viên_tự_quản_lý_công_việc, nhà_quản_lý_ít_giám_sát_nhân_viên
It would be beneficial if the company could provide clear growth opportunities and career path for senior employees who wish to specialize and advance in their technical skills.	nên_có_lộ trình_phát_triển_nghề_nghiệp_rõ_ràng
Cần system training chuyên nghiệp hơn cho người mới	cần_có_chương_trình_đào_tạo_chuyên_nghiệp_cho_nhân_viên_mới
- time flexible,	thời_gian_làm_việc_linh_hoạt
young environment	nhân_viên_trẻ
x2 salary, time flexible, nice,	thời_gian_làm_việc_linh_hoạt
- club yoga, aerobic, badminton, football	có_các_hoạt_động_rèn_luyện_sức_khỏe
rarely need to OT -	ít_làm_thêm_giờ
salary low	lương_thấp
Company have been located in Etown so the parking issue is no need to worry.	bãi_đỗ_xe_rộng_rãi
Colleages are very nice, friendly.	đồng_nghiệp_thân_thiện
It's fair that you are free to express your thoughts even with higher levels/managers.	tự_do_trình_bày_quan_điểm
Every departments have an serectary knowing eveythings.	có_thư_ký_riêng_mỗi_phòng_ban
Flexible working time base on each project.	thời_gian_làm_việc_linh_hoạt
It's base on team that some people are so impolite.	một_số_đồng_nghiệp_bất_lịch_sự
Because the company is seperated to many levels so benefits between departments also different way too far.	phúc_lợi_không_đồng_đều
Some departments will now pay you OT allowance but meal tickets instead, each of them worths 20k VND.	có_lương_và_chế_độ_làm_thêm_giờ
team members	thành_viên_nhóm
Managers/Leaders nhà_quản_lý
Quy trình onboarding	quy_trình_nhận_việc
team leader	trưởng_nhóm
lead/manager	nhà_quản_lý
hoà đồng		thân_thiện
district	huyện
leader	trưởng_nhóm
pebble	đá_cuội
wedding	lễ_cưới
voluntary	tình_nguyện
unneccessary	không_cần_thiết
comment	bình_luận
tphcm	thành_phố_hồ_chí_minh
thought	nghĩ
disrespected	không_tôn_trọng
unplug	rút_phích_cắm
urgency	khẩn_cấp
pool	hồ_bơi
baely	hiếm_khi
bought	mua
ngoc	ngọc
wrap	đóng_gói
Worm	sâu_máy_tính
muck	vấy_bẩn
class	lớp_học
hundred	hàng_trăm
macbook	macbook
loyalty	lòng_trung_thành
macbookos	macbook
stranger	người_lạ
get	nhận_được
Van Phong DEP	văn_phòng_đẹp
much	nhiều
level	cấp_độ
learge	học_hỏi
it	công_nghệ_thông_tin
crony	nối_khố
trade	thương_mại
lengthy	dài
entrance	cổng_vào
croissant	bánh_sừng_bò
is	là
ecspecially	đặc_biệt
sea	biển
violin	đàn_vi_ô_lông
flower	bông_hoa
quiet	yên_tĩnh
vertigo	chóng_mặt
thankyou	cảm_ơn_bạn
has	có
englisch	tiếng_anh
estuary	cửa_sông
shot	bắn
cod	cá_tuyết
winter	mùa_đông
hotel	khách_sạn
friendlyim	thân_thiện
mail	thư
canary	chim_hoàng_yến
excellences	xuất_sắc
street	đường_phố
linens	khăn_trải_giường
wonder	ngạc_nhiên
smell	mùi
yeah	vâng
redecoration	trang_trí_lại
clouds	mây
conditonal	có_điều_kiện
cactus	cây_xương_rồng
hoziron	chân_trời
hummorous	hài_hước
windy	có_gió
container	thùng_đựng_hàng
hotline	đường_dây_nóng
link	liên_kết
recieptionist	lễ_tân
flamingo	chim_hồng_hạc
teansfer	chuyển_khoản
lets	hãy
imperial	thành_nội
complain	than_phiền
impresion	sự_ép_buộc
resraurants	nhà_hàng
jacuzzi	bể_sục
resorted	nghỉ_dưỡng
gorgeous	rực_rỡ
shopaholics	người_nghiện_mua_sắm
nice	đẹp
waitress	nữ_phục_vụ
sparklingly	lấp_lánh
smashburger	bánh_mì_kẹp_thịt
foodstreets	thực_phẩm
mercury	thủy_ngân
omelettes	trứng_tráng
views	lượt_xem
eight	tám
hilltop	đỉnh_đồi
amenable	chịu_trách_nhiệm
off	tắt
go	đi
camera	máy_ảnh
pacakaged	đóng_gói
woody	thân_gỗ
bar	quán_ba
silver	bạc
decent	phong_nhã
spy	gián_điệp
omlets	ốp_lết
that	cái_đó
reception	tiếp_nhận
ratats	chuột_cống
coocking	nấu_nướng
tram	xe_điện
litters	lứa
exellent	tuyệt_vời
brand	nhãn_hiệu
station	ga_tàu
hogging	cuốc_đất
attendant	người_phục_vụ
cooking	nấu_nướng
skyline	đường_chân_trời
checkin	đăng_ký_vào
comfortable	thoải_mái
smelling	ngửi
gurgling	ọc_ọc
experiences	kinh_nghiệm
standard	tiêu_chuẩn
later	một_lát_sau
cheap	rẻ
wolud	sẽ
spaciuos	rộng_rãi
and	và
staff	nhân_viên
best	tốt
stolen	ăn_cắp
facelifting	đổi_mới
hostel	nhà_trọ
express	bày_tỏ
shopping	mua_sắm
intrepid	gan_dạ
unsalty	không_có_muối
eatery	quán_ăn
travel	du_lịch
haiphong	hải_phòng
supposed	được_cho_là
landscpaes	phong_cảnh
muse	ngân_nga
old	cũ
somerset	bộ_quần_áo
marvel	kỳ_quan
all	tất_cả
friendly	thân_thiện
path	con_đường
silkpath	con_đường_tơ_lụa
golden	vàng
pubbar	quán_rượu
could	có_thể
cute	dễ_thương
evergreen	thường_xanh
classic	cổ_điển
unity	thống_nhất
quirky	kỳ_quặc
lemongrass	cộng_sả
sofa	ghế_sô_pha
posh	sang_trọng
cheers	chúc_mừng
nhon	nhơn
north	bắc
breakfast	bữa_ăn_sáng
conceirge	nhân_viên_hướng_dẫn
thanks	cảm_ơn
holidays	ngày_lễ
living	cuộc_sống
hostess	bà_chủ
appaled	vỗ_về
police	cảnh_sát
frtont	trước_mặt
dalat	đà_lạt
perfect	hoàn_hảo
decorated	trang_trí
lullaby	hát_ru
forit	cho_nó
shark	cá_mập
voted	bình_chọn
bin	thùng_rác
caprilicious	đáng_yêu
are	là
taxi	xe_tắc_xi
support	ủng_hộ
barefoot	chân_trần
birding	tiếng_chim
bathroom	phòng_tắm
TRUE	thật
threatened	bị_đe_dọa
stay	ở_lại
beach	bờ_biển
ownermanager	quản_lý_chủ_sở_hữu
kiem	kiêm
silk	lụa
many	nhiều
bangalow	nhà_gỗ
with	với
bridge	cầu
windows	các_cửa_sổ
buding	chớm_nở
pear	lê
impeccable	có_thể
khen	khen_ngợi
dirty	dơ_bẩn
piano	đàn_piano
corkscrew	đồ_mở_nắp_chai
than	hơn
front	trước_mặt
promo	quảng_cáo
overlord	bá_vương
bakery	cửa_hàng_bánh_mì
firsly	đầu_tiên
magical	huyền_diệu
disappointed	thất_vọng
hospitality	lòng_hiếu_khách
suite	thượng_hạng
never	không_bao_giờ
zoom	thu_phóng
beautiful	xinh_đẹp
hosting	lưu_trữ
melody	làn_điệu
unforgottable	không_thể_nào_quên
reccomendation	sự_giới_thiệu
duver	thợ_lặn
peep	nhìn_trộm
bunch	bó
hospital	bệnh_viện
tatsy	ướt_át
charm	quyến_rũ
brunch	bữa_sáng_muộn
cookie	bánh_quy
figured	hình_dung
lilys	hoa_huệ
money	tiền_bạc
reveiw	làm_lại
hospital	bệnh_viện
stel	tấm_bia
baguettes	bánh_mì_baguette
walkin	bước_vào
intercontinal	liên_lục_địa
manky	lưu_manh
baguette	bánh_mì_dài
blacklist	danh_sách_đen
resor	người_bán_lại
doorman	người_gác_cửa
afterall	sau_tất_cả
water	nước
thai	thái
logic	hợp_lý
thuy	thủy
warm	ấm_áp
bohemien	phóng_túng
adorable	đáng_yêu
brasserie	quán_bia
didn	không
shining	sáng
walker	người_đi_bộ
sunbeds	giường_tắm_nắng
massage	mát_xa
leaf	lá_cây
restaunt	nhà_hàng
residences	cư_xá
cassia	trái_bả_đậu
pickering	hái_lượm
man	đàn_ông
operation	hoạt_động
traning	huấn_luyện
valentine	lễ_tình_nhân
fort	pháo_đài
inperial	thành_nội
spoons	thìa
desk	bàn
ever	không_bao_giờ
minimarts	siêu_thị_nhỏ
experence	kinh_nghiệm
quite	khá
recomend	gợi_ý
hazard	nguy_hiểm
line	hàng
vodka	rượu_vodka
place	địa_điểm
arrive	đến
perverts	những_kẻ_biến_thái
tamarind	quả_me
snow	tuyết
telling	nói
like	giống
hangar	nhà_chứa_máy_bay
barman	người_phục_vụ
wolfpack	bầy_sói
paradise	thiên_đường
partys	vợ_chồng
rise	tăng_lên
guests	khách
out	ngoài
nine	chín
yang	dương
rain	mưa
upside	ngược_lại
cheetah	con_báo
pink	hồng
double	gấp_đôi
arts	nghệ_thuật
well	tốt
crystal	pha_lê
bathtub	bồn_tắm
landscape	phong_cảnh
stressful	căng_thẳng
locker	khóa
kidgroup	nhóm_trẻ
terrific	khủng_khiếp
cleaners	chất_tẩy_rửa
hairgrip	kẹp_tóc
agreable	dễ_chịu
clothes	quần_áo
oaks	cây_sồi
pationate	gỉ_sắt
belle	bụng
domance	thống_trị
below	phía_dưới
killer	sát_thủ
amenties	tiện_nghi
elegant	thanh_lịch
clud	loảng_xoảng
brackfast	bữa_ăn_sáng
convinience	tiện
postoffice	bưu_điện
lily	hoa_loa_kèn
haggle	mặc_cả
pat	vỗ_nhẹ
squished	nhăn_nheo
choose	chọn
villas	biệt_thự
top	hàng_đầu
newly	mới
concept	ý_tưởng
phones	những_cái_điện_thoại
woefully	khốn_nạn
simplicity	sự_đơn_giản
admin	quản_trị_viên
social	xã_hội
reivew	ôn_tập
lovely	đáng_yêu
hurray	tiếng_hoan_hô
sad	buồn
but	nhưng
housemade	làm_tại_nhà
back	trở_lại
request	yêu_cầu
crepe	bánh_crepe
conditioner	dầu_xả
scam	lừa_đảo
overall	nhìn_chung
checking	kiểm_tra
loctaion	vị_trí
great	tuyệt_quá
panorama	toàn_cảnh
confirmed	đã_xác_nhận
remote	xa_xôi
luan	luân
yourselves	chính_bạn
residence	nơi_cư_trú
spice	gia_vị
hoarsening	khản_giọng
centre	trung_tâm
despite	bất_chấp
corner	góc
venue	hội_họp
jazzcuzi	bể_sục
mastic	gắn_gương
frendly	tự_do
good	tốt
said	nói
since	từ
classy	sang_trọng
seaside	bờ_biển
candy	kẹo
lunar	mặt_trăng
traveller	lữ_khách
hightly	cao_ngạo
muine	mũi_tên
travelblog	blog_du_lịch
flipside	lật_mặt
festival	lễ_hội
swiming	bơi_lội
jade	ngọc_bích
upside	lộn_ngược
parasailing	nhảy_dù
resort	phương_sách
lcoation	vị_trí
quanh	quánh
simple	đơn_giản
mix	pha_trộn
acccomdating	gia_nhập
ladies	quý_cô
mega	siêu_cấp
rosemary	cây_mê_điệt
master	bậc_thầy
gioi	giời
eden	vườn_địa_đàng
tout	chào_hàng
journey	hành_trình
brekky	rượu_bia
town	thị_trấn
recommend	giới_thiệu
indepence	sự_độc_lập
closeby	gần_đây
recipient	người_nhận
first	đầu_tiên
pm	nhân_viên_quản_lý_dự_án
lodge	lều
johny	ạ
unpleasant	khó_chịu
rogue	giả_mạo
overbooked	đặt_trước_quá_nhiều
cheating	gian_lận
scenic	phong_cảnh
minimart	siêu_thị_nhỏ
liker	người_nói_dối
towers	tháp
nail	móng_tay
infinity	vô_cực
enthusiastic	nhiệt_tâm
translate	phiên_dịch
successful	thành_công
apple	táo
butter	bơ
omg	chúa_ơi
pics	bức_ảnh
stank	hôi_thối
grey	màu_xám
traintickets	ve_xe_lửa
menu	thực_đơn
clean	dọn_dẹp
violet	màu_tím
memory	ký_ức
unusual	bất_thường
entree	đồng_ý
toot	thổi_còi
solo	đấu
sheets	tờ_giấy
openning	mở_ra
magnolia	mộc_lan
walking	đi_dạo
rainbow	cầu_vồng
attitude	thái_độ
utter	thốt_ra
welcomed	hoan_nghênh
decanter	bình_gạn
bang	tiếng_nổ
dorm	ký_túc_xá
swarm	họp_lại
rooms	phòng
traveling	đi_du_lịch
buddy	bạn_bè
scandinavia	bán_đảo_scandinavia
options	tùy_chọn
bieu	biều
jungle	rừng_nhiệt_đới
mate	người_bạn_đời
travellance	du_lịch
south	miền_nam
wave	làn_sóng
quat	quất
steak	miếng_bò_hầm
deluxe	sang_trọng
alot	rất_nhiều
value	giá_trị
nhit	nhắng_nhít
relax	thư_giãn
tomatoe	cà_chua
have	có
frienly	thân_thiện
beaches	bãi_biển
house	nhà_ở
righ	đúng
plus	thêm
customer	khách_hàng
aceptable	có_thể_chấp_nhận_được
comeback	sự_trở_lại
sevices	thiết_bị
party	buổi_tiệc
vietnan	việt_nam
cliff	vách_đá
vannot	không_thể
checkout	thủ_tục_thanh_toán
definitely	định_nghĩa
tan	rám_nắng
vacationtrip	chuyến_đi_nghỉ
slippery	trơn
epic	sử_thi
answers	câu_trả_lời
foggy	sương_mù
look	nhìn
owner	chủ_nhân
sweet	ngọt
light	ánh_sáng
tiny	nhỏ_bé
villa	biệt_thự
feel	cảm_thấy
rising	trỗi_dậy
tours	các_chuyến_du_lịch
layback	lùi_lại
enjoyable	thú_vị
scramble	tranh_giành
soap	xà_bông
honey	mật_ong
discovery	khám_phá
upsells	bán_thêm
avoid	tránh
forty	bốn_mươi
garden	vườn
oriced	có_giá_cao
sports	các_môn_thể_thao
think	suy_nghĩ
reasonable	hợp_lý
adveristed	tôn_thờ
scape	vật_tế_thần
park	công_viên
shuttle	đưa_đón
angst	sợ
evryday	hằng_ngày
grade	cấp
professional	chuyên_nghiệp
technology	công_nghệ
furnished	trang_bị
bluelake	hồ_xanh
hospitable	hiếu_khách
dormworld	thế_giới_ký_túc_xá
union	liên_hiệp
puolet	màu_tím
belongings	đồ_đạc
poshtel	sang_trọng
prepare	chuẩn_bị
song	bài_hát
tuyet	tuyết
jasmine	hoa_nhài
bandaids	khăn_rằn
coupon	phiếu_mua_hàng
brie	phô_mai_mềm_của_pháp
scene	bối_cảnh
resoet	phương_sách
valued	có_giá_trị
wellness	sức_khỏe
sended	đã_gửi
stronly	mạnh_mẽ
amenity	lể_nghi
roundtrip	khứ_hồi
sanitiser	chất_tẩy_rửa
coming	sắp_tới
leah	nhảy
bfast	bữa_ăn_sáng
toboggan	xe_trượt_băng
majetstic	chuyên_ngành
minibus	xe_buýt_nhỏ
bus	xe_buýt
incredible	đáng_kinh_ngạc
thing	điều
exelent	cường_tráng
snorkeling	lặn_với_ống_thở
phoenix	phượng_hoàng
discovey	khám_phá
most	phần_lớn
gross	tổng
swooping	sà_vào
appart	ứng_dụng
brownie	bánh_hạnh_nhân
expensive	đắt
volume	âm_lượng
backpacka	ba_lô
kindly	tử_tế
jounies	hành_trình
again	lần_nữa
happy	vui_mừng
gentlemab	quý_ông
mystery	huyền_bí
riverside	ven_sông
clam	yên_tĩnh
conviniently	thuận_tiện
moon	mặt_trăng
lifetime	cả_đời
near	ở_gần
chikdren	bọn_trẻ
sands	cát
repair	sửa
riverlife	cuộc_sống_trên_sông
august	tháng_tám
plaza	quảng_trường
rrats	chúc_mừng
mark	dấu
digs	đào
day	ngày
pariat	ban_giám_hiệu
arround	vòng_vây
smith	thợ_rèn
lobbybar	quầy_bar_ở_sảnh
hong	hồng
add	thêm_vào
practice	thực_hành
sceond	thứ_hai
coming	đến
art	nghệ_thuật
profasional	chuyên_nghiệp
earth	trái_đất
peacful	bình_yên
miniature	thu_nhỏ
square	quảng_trường
lougne	phòng_chờ
enough	đủ
bad	tệ
echo	tiếng_vang
plastic	nhựa_dẻo
renaissance	thời_phục_hưng
danang	đà_nẵng
breaky	vỡ
slags	đồ_ăn_mòn
resrot	phương_sách
long	dài
marker	đánh_dấu
attached	đính_kèm
hip	hông
store	cửa_hàng
awry	không_như_ý
lackluster	mờ_nhạt
halonh	hạ_long
sure	chắc_chắn_rồi
unbooked	chưa_đặt_trước
layover	trạm_dừng_chân
received	nhận
delay	sự_chậm_trễ
omletter	ốp_lết
sister	em_gái
ground	đất
medallion	huy_chương
touch	chạm
deliciuos	thơm_ngon
relation	quan_hệ
airmiles	dặm_bay
beyond	vượt_ra_ngoài
stylist	nhà_tạo_mẫu
call	gọi
hostell	nhà_trọ
cruis	du_thuyền
wows	chúc_mừng
tuna	cá_ngừ
confortable	thoải_mái
enjoy	thưởng_thức
together	cùng_với_nhau
kitchen	phòng_bếp
lama	lạt_ma
lots	rất_nhiều
easy	dễ_dàng
setup	thiết_lập
services	dịch_vụ
verygoof	rất_xa_vời
up	lên
dark	tối
exchange	đổi
valuable	quý_giá
untill	hết
boutique	cửa_hàng
read	đọc
ray	cá_đuối
view	lượt_xem
vip	cao_cấp
arrived	đã_đến
breathtaking	ngoạn_mục
welness	sự_thân_thiện
cranes	cần_cẩu
penh	pênh
lobby	sảnh_đợi
moutain	núi
roulette	cò_quay
overwelmed	choáng_ngợp
beachfront	bãi_biển
short	ngắn
family	gia_đình
perferct	hoàn_hảo
fortunate	may_mắn
ask	hỏi
rersort	phương_sách
smile	nụ_cười
blip	đốm_sáng
funny	buồn_cười
excellent	thông_minh
tanning	thuộc_da
anithyng	bất_cứ_thứ_gì
translator	người_phiên_dịch
spacieuse	khoảng_trống
flash	tốc_biến
duck	con_vịt
shack	lán
feed	cho_ăn
quality	chất_lượng
greatly	rất_nhiều
noboby	không_ai
autumn	mùa_thu
toilet	phòng_vệ_sinh
betel	trầu
salsa	điệu_salsa
through	xuyên_qua
only	chỉ_có
sent	gởi
aroma	hương_thơm
stumbled	vấp_ngã
bell	chuông
space	không_gian
chips	khoai_tây_chiên
recept	chấp_nhận
acient	cổ_xưa
engineer	kỹ_sư
maxim	châm_ngôn
forest	rừng
such	như_là
heritage	gia_tài
fairies	tiên_nữ
positives	tích_cực
massshe	mát_xa
everything	mọi_điều
paperthin	giấy_mỏng
powerpoints	điểm_mạnh
foot	chân
recepton	thụ_thể
fiinger	ngón_tay
prove	chứng_minh
show	chỉ
homstay	ở_nhà_người_bản_xứ
singer	ca_sĩ
luna	ánh_trăng
noisey	ồn_ào
bich	bích
nothing	không_có_gì
myvillage	làng_tôi
important	quan_trọng
bouique	cửa_hàng
arrival	đến
just	chỉ
towells	khăn_tắm
privet	mồi
bicycle	xe_đạp
phuong	phương
oldtown	phố_cổ
dungeon	ngục_tối
tribees	bộ_lạc
furbished	có_lông
suraunded	ngập_tràn
accomadtion	chỗ_ở
puplic	công_cộng
seat	ghế
coast	bờ_biển
unsympathetic	không_thông_cảm
broad	rộng_lớn
marine	hàng_hải
try	thử
successfully	thành_công
doorgirl	cô_gái_gác_cửa
surprise	sự_ngạc_nhiên
trouble	rắc_rối
excellentlent	xuất_sắc
wellcome	chào_mừng
furnitured	trang_bị
besides	ngoài_ra
star	ngôi_sao
checkincheckout	đăng_nhập._thoát_ra
interesting	hấp_dẫn
votere	bình_chọn
bungarlow	nhà_gỗ
be	là
combination	sự_phối_hợp
belt	thắt_lưng
head	cái_đầu
backpacking	ba_lô
recliners	ghế_tựa
gala	dạ_tiệc
princess	công_chúa
homie	người_nhà
lasagna	mì_nướng_kiểu_ý
toki	trượt_tuyết
mile	dặm
patien	kiên_nhẫn
citadel	thành_lũy
delight	hân_hoan
ooops	rất_tiếc
hill	đồi_núi
bowls	bát
continental	lục_địa
awesome	tuyệt_vời
forum	diễn_đàn
am	là
diving	lặn
nasties	tuổi_mới_lớn
angel	thiên_thần
pho	phở
burn	đốt_cháy
toilte	phòng_vệ_sinh
huyen	huyền
cotton	bông
company	công_ty
bien	biên
legap	cái_chân
raspberry	dâu_rừng
sanatized	làm_vệ_sinh
historic	mang_tính_lịch_sử
allright	được_rồi
review	đánh_giá
prior	trước
comparison	sự_so_sánh
unexpected	bất_ngờ
beware	coi_chừng
increase	tăng
opion	ý_kiến
suprise	ngạc_nhiên
replaced	thay_thế
nguyen	nguyên
understaffed	thiếu_nhân_sự
convinces	thuyết_phục
nheo	nheo_nhóc
of	của
vieew	lượt_xem
steam	hơi_nước
clostrophobic	nỗi_ám_ảnh
run	chạy
visa	hộ_chiếu
kiteboard	ván_diều
hochimihn	hồ_chí_minh
hapoened	đã_xảy_ra
hideout	nơi_ẩn_náu
use	sử_dụng
exeptional	đặc_biệt
lounge	phòng_chờ
doing	đang_làm
impressive	ấn_tượng
thx	cám_ơn
splurge	bắn_tung_toé
burger	bánh_mì_kẹp_thịt
cityview	cảnh_quan_thành_phố
lunch	bữa_trưa
bloke	nở_hoa
traveller	khách_du_lịch
flam	ngọn_lửa
malay	tiếng_mã_lai
thenhin	sau_đó
bargain	trả_giá
infested	bị_lây_nhiễm
soleil	đế_giày
daisy	hoa_cúc
morning	buổi_sáng
lol	cười_lớn
matraces	ma_trận
snapper	cá_hồng
resoer	phương_sách
yesterday	hôm_qua
tguong	thường
founder	người_sáng_lập
incharge	phụ_trách
experince	kinh_nghiệm
called	gọi_là
brings	mang_lại
stayed	đã_ở_lại
club	câu_lạc_bộ
lance	cây_thương
yacht	thuyền_buồm
royal	hoàng_gia
restaurant	nhà_hàng
bana	chuối
experiment	thí_nghiệm
homes	những_ngôi_nhà
eat	ăn
peapole	mọi_người
beerfresh	bia_tươi
rattled	lạch_cạch
serene	thanh_thản
happend	xảy_ra
alittle	một_chút
neighter	người_cận_thị
restaurang	nhà_hàng
canooing	chèo_thuyền
need	nhu_cầu
advisor	cố_vấn
above	ở_trên
breaksts	bẻ_gãy
vote	bỏ_phiếu
peking	bắc_kinh
marina	bến_du_thuyền
weed	cỏ_dại
sunflower	hoa_hướng_dương
vanity	tự_phụ
sex	tình_dục
cardinal	hồng_y
laundry	giặt_ủi
do	làm
pub	quán_rượu
organic	hữu_cơ
alley	ngõ
camping	cắm_trại
licatiin	vị_trí
blue	màu_xanh_da_trời
herbal	thảo_dược
helful	hữu_ích
there	ở_đó
rice	cơm
airpirt	sân_bay
hue	màu_sắc
mihouse	nhà_của_mi
quaters	người_xếp_hạng
mass	khối_lượng
skype	ứng_dụng_trò_chuyện
january	tháng_giêng
owers	chủ_nợ
app	ứng_dụng
hotels	nhiều_khách_sạn
dessole	áo_lót
salad	rau_xà_lách
travels	du_lịch
sand	cát
peddling	bán_rong
hoang	hoàng
fusion	dung_hợp
blurb	sự_lộn_xộn
scenery	phong_cảnh
conkhach	ốc_xà_cừ
locked	bị_khóa
batender	người_pha_chế_rượu
pepper	tiêu
ofas	như_là
harbour	hải_cảng
chineese	người_trung_quốc
dinner	bữa_tối
sunny	nắng
regards	trân_trọng
tequila	rượu_tequila
villarge	làng
tables	những_cái_bàn
chilling	rùng_mình
swiss	thụy_sĩ
writes	viết
invoice	hóa_đơn
amenaties	tiện_nghi
checkeout	rô_to
hours	giờ
milk	sữa
tooooo	quá
bellman	người_đánh_chuông
nature	thiên_nhiên
bash	bấu_víu
alcove	hốc_tường
little	ít
dust	bụi_bặm
allsorts	tất_cả_các_loại
hoards	tích_trữ
qualities	phẩm_chất
moldy	bị_mốc
lightly	nhẹ_nhàng
stat	chỉ_số
sunloungers	ghế_tắm_nắng
hack	gian_lận
moment	chốc_lát
popping	bốp
fax	số_fax
ghostly	ma_quái
cabbie	người_lái_taxi
corteseous	kháu_khỉnh
vietnam	việt_nam
duplex	song_công
hien	hiền
fan	quạt
sếp	nhà_quản_lý
headscratcher	thợ_cạo_đầu
raked	cào
large	lớn
corridor	công_ty_cổ_phần
lanterns	đèn_lồng
liu	liu_điu
playlist	danh_sách_phát
plesant	khó_chịu
dribbled	rê_bóng
non	không
avarage	trung_bình_cộng
sky	bầu_trời
team	đội
underwhelming	áp_đảo
eo	eo_ơi
nigts	đêm
bill	hóa_đơn
thang	thắng
land	đất_đai
comforable	thoải_mái
confirm	xác_nhận
smoothies	sinh_tố
bean	hạt_đậu
manager	giám_đốc
package	gói
thuc	thục
superb	tuyệt_vời
regency	nhiếp_chính
hi	chào
stopover	dừng_chân
gorget	tiện_ích
hat	mũ
tanh	tánh
truly	thực_sự
cockerel	gà_trống
ngoai	ngoại
nights	đêm
hers	của_cô_ấy
accueillant	người_tố_cáo
mountain	núi
also	cũng_thế
simcard	thẻ_sim
bicylces	xe_đạp
bedsheets	ga_trải_giường
anyways	dù_sao_đi_nữa
harmony	hòa_hợp
sling	treo_lên
lavender	hoa_oải_hương
convientely	thuận_tiện
healthy	khỏe_mạnh
crossaint	bánh_sừng_bò
anything	bất_cứ_thứ_gì
tomorrow	ngày_mai
cosy	ấm_cúng
over	kết_thúc
welll	hàn
rat	con_chuột
island	đảo
break	phá_vỡ
yearend	hết_năm
eqipment	trang_thiết_bị
ensuites	quần_áo
warmly	nồng_nhiệt
mouthwatering	vừa_miệng
quest	nhiệm_vụ
horrible	kinh_khủng
dance	nhảy
city	thành_phố
fancy	mến
seasons	các_mùa
vac	bỏ_trống
bartender	người_pha_chế_rượu
viatnamese	tiếng_việt
onetrip	một_chuyến_đi
mercure	thương_xót
hamocks	võng
aloe	nha_đam
um	ừm
motobike	xe_máy
ok	ổn
compfty	tài_giỏi
therapit	nhà_trị_liệu
veraemente	hiên_ngang
screaming	la_hét
quadruple	bốn_người
meet	gặp
concierge	nhân_viên_hướng_dẫn
hotellocation	vị_trí_khách_sạn
funky	sôi_nổi
grumpy	gắt_gỏng
huong	hương
riddled	câu_đố
thien	thiên
koi	cá_koi
via	thông_qua
tuan	anh_tuấn
smiles	nụ_cười
ruby	hồng_ngọc
safary	an_toàn
point	điểm
funcioning	hoạt_động
airblade	lưỡi_không_khí
messenger	tin_nhắn
boattour	thuyên_du_lịch
sattelite	vệ_tinh
finger	ngón_tay
tigon	hổ_sư
photobombing	ghép_ảnh
which	cái_nào
untampered	chưa_được_kiểm_tra
how	làm_sao
unplanned	không_có_kế_hoạch
factory	nhà_máy
villass	con_chó
book	sách
bunaglows	nhà_gỗ
host	tổ_chức
foir	ngựa_con
craft	thủ_công
cctv	camera_quan_sát
fault	lỗi
outing	đi_chơi_xa
bright	sáng
birthday	sinh_nhật
cheats	gian_lận
service	dịch_vụ
mama	má
fabulous	tuyệt_vời
phone	điện_thoại
home	trang_chủ
guys	các_bạn
re	lại
extremely	vô_cùng
latte	pha_cà_phê
smart	thông_minh
giap	giáp
lady	quý_bà
butterbeer	bia_bơ
angered	tức_giận
everyone	tất_cả_mọi_người
horizon	chân_trời
gamer	game_thủ
boss	ông_chủ
global	toàn_cầu
tour	chuyến_du_lịch
verging	bờ_vực
importance	tầm_quan_trọng
sunsea	hoàng_hôn
homely	thân_thiện
oasis	ốc_đảo
mr	ông
emproved	tán_thành
love	yêu_và_quý
awful	kinh_khủng
matresses	nệm
usd	đô_la_mỹ
chef	bếp_trưởng
verymuch	rất_nhiều
cafe	quán_cà_phê
restoran	phục_hồi
needs	nhu_cầu
hey	chào
ensuite	phòng_tắm
building	xây_dựng
makes	làm_cho
deli	cửa_hàng_thức_ăn_ngon
exceptionnel	kênh_ngoại_lệ
province	tỉnh
condote	dẫn_lời
hum	ngân_nga
felt	cảm_thấy
vietinbank	ngân_hàng_vietinbank
may	có_thể
tatashow	chiếu_tatashow
ebb	hạ_xuống
huan	huân
various	đa_dạng
loundry	giặt_ủi
experience	kinh_nghiệm
hanriver	sông_han
necrotizing	hoại_tử
associates	cộng_sự
fusionrisort	hợp_nhất
village	làng
retreat	rút_lui
muslim	hồi
rock	đá
rooftop	sân_thượng
manage	quản_lý
span	nhịp
luck	may_mắn
expectationsthat	kỳ_vọng
gutted	rút_ruột
amazinggggg	tuyệt_vờigggg
amamzing	kinh_ngạc
crazy	khùng
easygoing	dễ_dãi
berry	quả_mọng
maple	cây_phong
anwe	sợ_hãi
recommened	đề_nghị
speacial	đặc_biệt
lieuw	liễuw
socola	sô_cô_la
shrims	tôm
trip	chuyến_đi
driver	người_lái_xe
didnt	không
pine	cây_thông
breackfast	bữa_ăn_sáng
doughy	nhão_nhoét
protein	chất_đạm
definitley	chắc_chắn
security	bảo_vệ
resturant	nhà_hàng
locatiin	vị_trí
official	chính_thức
brdige	cầu
behaviors	hành_vi_cư_xử
chicken	thịt_gà
getting	nhận_được
laf	không_có_nghĩa
denonstrates	minh_chứng
premium	cao_cấp
literie	người_biết_chữ
vitnam	việt_nam
miss	cô
toute	chào_hàng
sesame	mè
alcarte	gọi_món
everywhere	mọi_nơi
suiting	kiện_cáo
must	phải
design	thiết_kế
howerver	tuy_nhiên
elevator	thang_máy
mosquitos	muỗi
ameneties	tiện_nghi
desgin	thiết_kế
windmills	cối_xay_gió
tidier	ngăn_nắp_hơn
bot	người_máy
porch	hiên_nhà
bonus	tặng_kem
lying	nói_dối
vet	bác_sĩ_thú_y
musky	xạ_hương
delicous	thơm_ngon
sound	âm_thanh
serenade	dạ_khúc
arriving	đến_nơi
stayin	ở_lại
doting	lẩm_cẩm
siagon	sài_gòn
luong	luồng
diep	điệp
mad	điên
river	con_sông
gallery	bộ_sưu_tập
saigon	sài_gòn
allways	mọi_cách
no	không
ages	lứa_tuổi
alert	cảnh_giác
food	món_ăn
landmark	phong_cảnh
creak	cót_két
siesta	giấc_ngủ_trưa
robes	áo_choàng
awared	cảnh_giác
butler	quản_gia
wind	gió
cozy	ấm_cúng
keg	thùng
expectations	kỳ_vọng
stunning	kinh_ngạc
ones	những_cái
bub	bọt
counters	quầy_giao_dịch
airport	sân_bay
rim	vành
atsmosphere	không_khí
acti	hoạt_động
vets	bác_sĩ_thú_y
treeated	trồng_cây
lantern	đèn_lồng
checked	đã_kiểm_tra
dissapointed	thất_vọng
annoyance	khó_chịu
me	tôi
kayle	thuyền_kayle
hangout	đi_ra_ngoài
immaculate	vô_nhiễm
housekeeping	dọn_phòng
feeling	cảm_giác
post	bài_đăng
hapiness	hạnh_phúc
twin	sinh_đôi
dining	ăn_uống
virus	vi-rút
wonderful	tuyệt_vời
floating	nổi
didint	không
phuc	phúc
charged	tính_phí
weater	thời_tiết
excelent	tuyệt_vời
satifying	hài_lòng
bay	vịnh
wowwowwow	tuyệt_tuyệt_tuyệt
fresh	tươi
sitetour	tour_du_lịch_trang_web
guesthouse	nhà_khách
huge	khổng_lồ
small	nhỏ
cheat	lừa_đảo
sales	bán_hàng
dip	nhúng
cotu	cơtu
absolutley	chắc_chắn_rồi
prorate	chia_theo_tỷ_lệ
confortable	có_thể_kết_nối
even	cũng
population	dân_số
tinfoil	giấy_thiếc
kitted	mèo_con
dragon	rồng
guitar	đàn_ghi_ta
huanh	hoàng
bordet	giáp_ranh
sadly	thật_đáng_buồn
sraff	con_quỷ
barbecue	tiệc_nướng_ngoài_trời
condos	căn_hộ
kind	tốt_bụng
motorcycle	xe_máy
neverland	vùng_đất_thần_thoại
discusting	thảo_luận
strongly	mạnh_mẽ
tacos	bánh_tét
braethtaking	ngoạn_mục
kha	khà
seaview	hướng_biển
rank	cấp
replace	thay_thế
adventures	những_cuộc_phiêu_lưu
relaxation	thư_giãn
eyes	đôi_mắt
eh	hở
waterpark	công_viên_nước
evening	tối
bedder	người_đi_ngủ
omlette	ốp_lết
importantly	quan_trọng
thank	cảm_tạ
romance	lãng_mạn
cheched	đã_kiểm_tra
friend	bạn_bè
duffle	vải_thô
action	hoạt_động
cashier	thu_ngân
partner	cộng_sự
selfie	chụp_ảnh_tự_sướng
sunlight	ánh_nắng_mặt_trời
cool	mát_mẻ
ideas	ý_tưởng
would	sẽ
max	tối_đa
vacation	kỳ_nghỉ
force	lực_lượng
doormen	người_gác_cửa
frd	thứ_ba
unfriendly	không_thân_thiện
cackling	nói_nhỏ
you	bạn
banquet	yến_tiệc
cigarettes	thuốc_lá
seaweed	rong_biển
owns	sở_hữu
tropical	nhiệt_đới
megamall	trung_tâm_thương_mại_lớn
sin	tội
tried	đã_thử
poond	trầm_ngâm
appreaciate	đánh_giá
welcome	chào_mừng
flavoursome	hương_vị
spotless	không_tì_vết
lied	đã_nghe
wad	một_xấp
recommed	gợi_ý
reccommend	đề_nghị
coffeebean	hạt_cà_phê
villla	biệt_thự
bikeride	đạp_xe
fantastic	tuyệt_diệu
dew	sương
fourday	bốn_ngày
thuong	thường
unfortuanatly	không_may
on	trên
die	chết
backy	trở_lại
neighboors	người_hàng_xóm
windowview	cửa_sổ
aisling	lối_đi
caf	quán_cà_phê
heloed	say_mê
pomelos	bưởi
oberwatch	ghi_đè
slippy	trơn_trượt
trink	đồ_vặt
moments	khoảnh_khắc
become	trở_nên
question	câu_hỏi
quarter	phần_tư
homecooked	nấu_chín
motel	nhà_trọ
indoor	trong_nhà
makong	chế_tạo
azalea	cây_đổ_quyên
outlet	lối_thoát
dod	né_tránh
anyway	dù_sao
serviceman	người_phục_vụ
huu	hữu
oct	tháng_10
cherry	quả_anh_đào
senses	giác_quan
foodie	người_sành_ăn
survice	phụ_tá
dung	phân
update	cập_nhật
trom	trôm
yea	vâng
guy	chàng
homestay	ở_nhà_người_bản_xứ
about	trong_khoảng
ppl	mọi_người
loyality	trung_thành
hosts	máy_chủ
metro	tàu_điện
sohotel	khách_sạn
shell	vỏ
fireworks	bắn_pháo_hoa
wc	nhà_vệ_sinh
petite	nhỏ
train	xe_lửa
teen	tuổi_teen
execelent	thông_minh
balcony	ban_công
buiding	xây_dựng
halong	hạ_long
offputting	đặt_ra
hammers	búa
understand	hiểu_biết
bedrooms	phòng_ngủ
apartments	căn_hộ
spaghetti	mì_ống_ý
kictchen	phòng_bếp
different	khác_nhau
wasnt	không
connection	kết_nối
buggy	có_lỗi
dudes	anh_chàng
tragedia	bi_kịch
snotty	lém_lỉnh
door	cửa
eveyone	tất_cả_mọi_người
jenny	cú_chọc
red	đỏ
skyping	bay_lên
pricy	quý_giá
gateman	người_gác_cổng
deep	sâu
amazibg	kinh_ngạc
sorry	lấy_làm_tiếc
tonic	thuốc_bổ
robot	người_máy
duc	đức
cpmpletely	hoàn_toàn
cottage	nhà_tranh
washing	rửa
simoly	đơn_giản
iphone	điện_thoại_iphone
hot	nóng_bức
file	tập_tin
zero	số_không
bungalow	nhà_gỗ
writting	viết_lách
exec	người_điều_hành
shelter	nơi_trú_ẩn
hideway	ẩn_đi
bungalows	nhà_gỗ
thumb	ngón_tay_cái
three	số_ba
amber	hổ_phách
wait	chờ_đợi
everybody	mọi_người
familydinners	gia_đình
makeup	trang_điểm
backless	không_có_lưng
gym	phòng_thể_dục
resraurent	nhà_hàng
normal	bình_thường
bich	bạch_dương
smarttv	tv_thông_minh
your	của_bạn
photo	tấm_ảnh
luv	yêu
shop	cửa_tiệm
previous	trước
comes	đến
stars	các_ngôi_sao
omeletts	trứng_tráng
wouldn	sẽ_không
wpuld	sẽ
attracfion	sự_hấp_dẫn
nightmarket	chợ_đêm
alquilar	giống_nhau
splendid	lộng_lẫy
fantasic	tuyệt_diệu
godd	trời_ơi
horrendous	kinh_khủng
amply	đủ
triet	triết
compering	so_sánh
xouldnt	không_thể
rolls	bánh_cuốn
foreign	ngoại_quốc
wide	rộng
moons	mặt_trăng
mushroom	nấm
khoi	khôi
connect	kết_nối
capsule	viên_con_nhộng
pen	cây_bút
canal	con_kênh
impression	ấn_tượng
pudding	bánh_pudding
craving	thèm_muốn
quitely	chuyên_tâm
bonsai	cây_cảnh
demanded	yêu_cầu
kingsize	cỡ_lớn
loop	vòng
main	chủ_yếu
frienfly	thân_thiện
perle	lần
hometown	quê_nhà
resteraunt	nhà_hàng
forvthem	cho_họ
cafebar	quán_cà_phê
weekeind	cuối_tuần
definetely	chắc_chắn
scarlet	đỏ_tươi
travelers	du_khách
nham	nhâm
box	cái_hộp
take	lấy
lougnge	phòng_chờ
takeaway	lấy_đi
clran	dọn_dẹp
rent	thuê
skylight	giếng_trời
rip	yên_nghỉ
vile	hèn_hạ
music	âm_nhạc
unintrested	không_quan_tâm
pesonally	cá_nhân
holtel	khách_sạn
plum	mận
outside	ở_ngoài
surfshop	cửa_hàng_lướt_sóng
litter	xả_rác
wheel	bánh_xe
visit	chuyến_thăm
freestanding	tự_do
lay	đặt_nằm
ficility	cơ_sở
ref	tham_khảo
nomad	du_mục
bugs	lỗi
trick	lừa
homecooking	nấu_ăn_ở_nhà
was	đã
bulgalow	nhà_gỗ
aquaculture	nuôi_trồng_thủy_sản
quaint	cổ_kính
style	phong_cách
pancakes	bánh_xèo
babysister	người_trông_trẻ
problem	vấn_đề
temptation	sự_cám_dỗ
fish	cá
incthe	bên_trong
comportable	có_thể_so_sánh_được
toasty	ăn_ngon
maverlous	kỳ_diệu
rette	nói_lại
idea	ý_tưởng
keeping	duy_trì
overnighter	quá_sức
to	đến
laneway	làn_đường
price	giá_bán
creating	tạo_ra
memorable	đáng_nhớ
gold	vàng
haipong	hải_phòng
arpril	tháng_tư
already	đã_sẵn_sàng
goings	đi
stank	ngân_hàng
nutella	bơm
wouldnt	sẽ_không
evetything	mọi_điều
traveler	lữ_khách
nastiest	xấu_nhất
lag	lỗi
loudly	ầm_ĩ
single	độc_thân
cup	cốc
fusty	xưa
unprofessional	không_chuyên_nghiệp
does	làm
basil	húng_quế
beware	chăm_sóc
dificult	khó_khăn
pad	tập_giấy
executive	điều_hành
rockhard	đá_cứng
seahorse	cá_ngựa
salamanders	kỳ_nhông
thrue	xuyên_qua
heaven	thiên_đường
frendship	hữu_nghị
detox	giải_độc
i	tôi
christine	nguyên_sơ
were	là
ocean	đại_dương
sandwich	bánh_mì_sandwich
garde	làm_vườn
backpacker	tây_ba_lô
excutive	điều_hành
receipt	biên_lai
fun	vui_vẻ
rockclimbing	leo_núi
times	lần
witho	với
walkie	máy_đi_bộ
retro	cổ_điển
chillout	thư_giãn
loug	lười_biếng
rustic	mộc_mạc
hue	huế
decorate	trang_trí
swimming	bơi_lội
flops	thất_bại
everyday	hằng_ngày
popped	xuất_hiện
mon	thứ_hai
styles	phong_cách
side	bên
part	phần
papermap	bản_đồ_giấy
media	phương_tiện_truyền_thông
meals	bữa_ăn
chat	trò_chuyện
free	miễn_phí
kicked	đá
century	thế_kỷ
teeup	thiếu_niên
queen	nữ_hoàng
freedomland	đất_tự_do
safebox	két_sắt
airy	thoáng_đãng
professionalism	sự_chuyên_nghiệp
online	trực_tuyến
downtown	trung_tâm_thành_phố
houseskipping	bỏ_nhà_đi
moan	kêu_van
fullmoon	trăng_tròn
restraunt	nhà_hàng
tittle	nói_nhỏ
bespoke	thiết_kế_riêng
bud	chồi
feet	đôi_chân
spread	lây_lan
code	mã
bol	bu_lông
holiday	ngày_lễ
buck	cái_xô
refresh	làm_tươi
passport	hộ_chiếu
mosquitoes	muỗi
navy	hải_quân
selected	đã_chọn
auguest	tháng_tám
ratt	tiếng_lục_lạc
lung	phổi
loan	tiền_vay
uncel	bỏ_chọn
familly	gia_đình
camel	lạc_đà
viatnam	việt_nam
deco	trang_trí
asia	châu_á
buffer	đệm
againj	lạij
pillow	cái_gối
boo	ụt
flan	bánh_flan
kayak	chèo_xuồng
noisebed	giường_ồn_ào
worse	tệ_hơn
terrible	khủng_khiếp
coffee	cà_phê
execellent	thông_minh
avatar	hình_đại_diện
xen	xen_kẽ
hit	đánh
hishown	của_mình
friends	bạn_bè
poor	nghèo
understatement	sự_nói_nhỏ
item	mục
bout	cơn
sun	mặt_trời
skylit	bầu_trời
edition	phiên_bản
verygood	rất_tốt
name	tên
resp	đáp_lại
shower	vòi_sen
zakuzi	bể_sục
familie	gia_đình
men	đàn_ông
platinum	bạch_kim
expierience	kinh_nghiệm
damg	chết_tiệt
finds	tìm_thấy
hochiminh	hồ_chí_minh
bed	giường
lcrthanks	lcr_cảm_ơn
masseuses	mát_xa
grill	nướng
kitty	mèo_con
cake	bánh_ngọt
nightbus	xe_buýt_đêm
worth	thật
nhanh	nhanh_chóng
castaway	người_đi_thiến
boggling	nói_dối
mins	phút
cathedral	nhà_thờ_lớn
pacific	thái_bình_dương
noi	không_có_i
asking	hỏi
fairy	nàng_tiên
croak	lạch_cạch
supper	bữa_tối
shops	cửa_hàng
breaky	vỡ_vụn
beyound	vượt_ra_ngoài
foward	đi_trước
therapist	nhà_trị_liệu
hut	túp_lều
backpacer	tây_ba_lô
recommdable	đáng_tin_cậy
skate	giày_trượt_băng
sitting	ngồi
highland	cao_nguyên
grand	lớn
thougt	nghĩ
diet	chế_độ_ăn
im	tôi
honking	bấm_còi
emerald	ngọc_lục_bảo
brilliant	xuất_sắc
tin	thiếc
marts	siêu_thị
caring	quan_tâm
size	kích_thước
built	được_xây_dựng
exepcted	hy_vọng
spacious	rộng_rãi
her	cô_ấy
tailormade	may_rủi
toiletteries	đồ_dùng_vệ_sinh
noodle	bún
omelett	trứng_tráng
tjrough	xuyên_qua
camellia	hoa_trà
calibre	tầm_cỡ
cuong	cường
hesitant	do_dự
air	không_khí
kidclub	câu_lạc_bộ_trẻ_em
luggage	hành_lý
jan	tháng_một
goodrecommend	chúc_mừng
ambassdor	đại_sứ
grande	ông_lớn
coop	chuồng_ngựa
some	một_số
faff	ngu_ngốc
buss	hôn
bowngalows	nhà_gỗ
palm	lòng_bàn_tay
fully	đầy_đủ
white	trắng
seashell	vỏ_sò
unfogetble	không_thể_lay_chuyển
come	đến
vietnamise	tiếng_việt
eco	sinh_thái
will	sẽ
soon	sớm
vegan	thuần_chay
outting	đi_chơi
experirence	kinh_nghiệm
packbacker	tây_ba_lô
pleasure	vui_lòng
trekking	đi_bộ_đường_dài
discutiendo	phản_đối
nguyen	nguyễn
ton	tấn
percent	phần_trăm
khoai	khoai_tây
fammily	gia_đình
waiter	phục_vụ_nam
honeymoon	tuần_trăng_mật
flowers	những_bông_hoa
omeletes	trứng_tráng
laptop	máy_tính_xách_tay
pooltable	hồ_bơi
frieldly	thân_thiện
pastel	màu_phấn
shhhhh	suỵt
genuine	chính_hãng
centrally	trung_ương
confort	kết_tội
trasfering	chuyển_giao
thoai	thoại
not	không_phải
safe	an_toàn
became	đã_trở_thành
homemade	tự_làm
shoutout	la_lên
mildew	nấm_mốc
authentic	xác_thực
catcat	mèo_mèo
type	kiểu
receptionist	lễ_tân
restrurant	nhà_hàng
loved	yêu
orchidees	tinh_hoàn
barroness	nam_tước
cleanstaff	làm_sạch
damage	hư_hại
mouldy	bị_mốc
counter	quầy_tính_tiền
seasde	bờ_biển
cruise	du_thuyền
quots	dấu_ngoặc_kép
helpful	hữu_ích
year	năm
count	đếm
glazed	tráng_men
ultra	cực_kỳ
trek	đi_bộ
glad	vui_vẻ
at	tại
sting	châm_chích
outstanding	nổi_bật
drawers	ngăn_kéo
loope	dây_buộc
shittier	dở_hơi
beachside	bên_bờ_biển
htoel	khách_sạn
switch	công_tắc_điện
zest	sự_hăng_hái
kiteboending	thả_diều
cutee	dễ_thương
cactusrine	cây_xương_rồng
worse	thật
brainstorming	động_não
laze	ngủ_quên
honnestly	thành_thật
time	thời_gian
had	đã_có
phonecall	gọi_điện
apologies	lời_xin_lỗi
location	vị_trí
rickety	ọp_ẹp
okthank	được_rồi,_cảm_ơn
booking	đặt_trước
luxury	sang_trọng
accomodations	chỗ_ở
watress	nữ_phục_vụ
introduced	giới_thiệu
jack	giắc_cắm
disapointed	thất_vọng
hole	hố
oven	lò
quen	dập_tắt
find	tìm_thấy
soul	linh_hồn
brunch	chiếc
stationall	trạm
visiting	thăm_viếng
bufft	tiệc_đứng
pay	trả
spesk	nói
squeaky	kêu_cót_két
landscaping	phong_cảnh
division	sự_phân_chia
apt	đúng_cách
restroom	phòng_vệ_sinh
receptie	người_nhận
swipe	vuốt
thongs	dép_lê
supprise	cung_cấp
tea	trà
treks	chuyến_đi
ziplines	dây_khóa_kéo
personas	cá_tính
amieneties	hòa_nhã
explor	giải_thích
unkindly	không_ngoan
nationalpark	công_viên_quốc_gia
tennis	quần_vợt
luminous	sáng
baskin	da_bò
rendezvous	điểm_hẹn
included	bao_gồm
aqua	nước_biển
before	trước
palace	cung_điện
sage	hiền_nhân
thom	thơm
vicent	nạn_nhân
wayfinding	tìm_đường
rates	giá
couples	các_cặp_đôi
cookies	bánh_quy
iam	tôi_là
outstandingly	xuất_sắc
terracotta	đất_nung
grouse	cằn_nhằn
starlight	ánh_sao
big	lớn
smoke	khói
missing	còn_thiếu
maintainace	bảo_trì
wildland	hoang_dã
tet	ngày_tết
sailing	thuyền_buồm
charming	duyên_dáng
drivermr	người_lái_xe
wester	miền_tây
tab	chuyển_hướng
duoing	bộ_đôi
acoustic	âm_thanh
maps	bản_đồ
say	nói
kite	cánh_diều
empty	trống
teracotta	đất_nung
celsius	độ_c
worthy	xứng_đáng
immaculately	ngay_lập_tức
king	nhà_vua
sum	tổng
amount	số_tiền
amzing	kinh_ngạc
hoit	cuốc_đất
peace	sự_thanh_bình
trendy	hợp_thời_trang
tell	nói
frangipani	hoa_sứ
poolbar	hồ_bơi
confy	hoa_giấy
cook	nấu_ăn
supervisor	người_giám_sát
jaccuzi	bể_sục
thanknyou	cảm_ơn_bạn
backy	lưng_chừng
cob	lõi_ngô
highlight	điểm_nổi_bật
waterbungalows	cây_nước
wolf	chó_sói
bank	ngân_hàng
choice	lựa_chọn
pushy	tự_đề_cao
beautifull	đẹp_đẽ
ailen	người_ngoài_hành_tinh
awards	giải_thưởng
resteraunts	nhà_hàng
facilities	cơ_sở_vật_chất
an	một
shade	bóng_râm
leisure	giải_trí
original	nguyên
livelier	sống_động_hơn
victory	chiến_thắng
nightmare	ác_mộng
specials	đặc_biệt
cocobus	xe_buýt
fitness	sự_khỏe_khoắn
floor	sàn_nhà
where	ở_đâu
uyen	uyên
frypans	chảo_rán
annual	hàng_năm
sunrise	bình_minh
devoted	hết_lòng
travellers	du_khách
switches	chuyển_đổi
tone	tấn
dicovery	khám_phá
convinent	tiện_lợi
strike	đình_công
weeken	ngày_cuối_tuần
guidance	hướng_dẫn
tien	tiến
rag	giẻ
twice	hai_lần
theres	ở_đó
smoothie	sinh_tố
phai	phái
six	sáu
local	địa_phương
onsen	suối_nước_nóng
staying	ở_lại
takecare	bảo_trọng
dope	gây_nghiện
office	văn_phòng
insight	cái_nhìn_sâu_sắc
swindled	lừa_dối
if	nếu
dryer	máy_sấy_khô
contact	tiếp_xúc
gooseberries	quả_lý_gai
nobody	không_ai
airlines	các_hãng_hàng_không
ran	đã_chạy
acoutic	âm_thanh
reseption	tiếp_nhận
shirt	áo_sơ_mi
khuong	khương
reconfirm	xác_nhận_lại
stuffs	chất_liệu
kid	đứa_trẻ
hall	đại_sảnh
super	siêu
furniture	đồ_nội_thất
people	mọi_người
reccomend	đề_nghị
apartment	căn_hộ,_chung_cư
server	người_phục_vụ
discount	giảm_giá
peaceful	bình_yên
cloud	đám_mây
vientam	việt_nam
delious	mê_sảng
thuan	thuận
perfume	nước_hoa
very	rất
yellownish	hơi_vàng
bossman	ông_chủ
dam	đầm
voting	biểu_quyết
lights	đèn
homely	quê_mùa
bedroom	phòng_ngủ
sgranate	quả_lựu
other	khác
occopancy	chiếm_dụng
alas	chao_ôi
jummy	vui_vẻ
curt	cộc_lốc
its	nó_là
motobikes	xe_máy
goumet	người_sành_ăn
chesses	cờ_vua
clover	cỏ_ba_lá
screeching	rít_lên
china	trung_quốc
deli	đồ_nguội
beerpong	thùng_bia
orange	trái_cam
belw	ợ
populars	bình_dân
concierge	người_hướng_dẫn
whitehouse	nhà_trắng
because	bởi_vì
quynh	quỳnh
home	nhà
meatball	thịt_viên
cloudy	nhiều_mây
motor	động_cơ
oops	giáo_sư
elegance	trang_nhã
behome	ở_nhà
clup	tiếng_vỗ_tay
terible	khó_khăn
casas	áo_cà_sa
glamour	sự_hào_nhoáng
anise	cây_hồi
jazz	nhạc_jazz
superior	cấp_trên
higly	cao_nhất
trainee	thực_tập_sinh
coustmer	khách_hàng
grass	cỏ
fuss	làm_phiền
estate	động_sản
locatiom	địa_điểm
tower	tòa_tháp
vibe	rung_cảm
depoait	tiền_gửi
clip	kẹp
position	chức_vụ
monsieur	ngài
fine	khỏe
siesta	ngủ_trưa
put	đặt
viewfriendly	nhìn_thân_thiện
eftpose	đa_năng
supperior	cấp_trên
hesitate	do_dự
entertaining	giải_trí
bat	con_dơi
can	có_thể
brillant	rực_rỡ
drinkand	uống_rượu
lerendezvous	điểm_hẹn
amore	tình_yêu
olde	người_già
messages	tin_nhắn
syrup	xi-rô
whole	toàn_bộ
romantic	lãng_mạn
recomended	đề_nghị
under	dưới
horse	con_ngựa
obliging	nghĩa_vụ
tripple	vấp_ngã
personable	dễ_thương
restaruants	nhà_hàng
fruit	trái_cây
fig	quả_sung
charge	sạc_điện
cititel	thành_phố
freind	tự_do
asked	yêu_cầu
redicilous	nực_cười
falling	rơi
installation	cài_đặt
yourself	bản_thân_bạn
atmostphere	không_khí
smudgy	nhòe_nhoẹt
condotel	căn_hộ_du_lịch
totsl	toàn_bộ
mummas	mẹ
merrily	vui_vẻ
groc	cái_rãnh
thats	đó_là
nacks	ngủ_trưa
broken	bị_hỏng
biggie	lớn
coffe	cà_phê
ago	trước_đây
bicicles	xe_đạp
semaines	học_kỳ
safety	sự_an_toàn
brightest	sáng_nhất
auto	tự_động
weekend	ngày_cuối_tuần
sligthly	nhẹ_nhàng
housekeeper	người_quản_gia
kids	trẻ_em
villlas	biệt_thự
vuong	vương
sufing	lướt_ván
night	đêm
beggining	bắt_đầu
ticks	bọ_ve
visiter	người_đến_thăm
wear	mặc
bambooforest	rừng_tre
hr	giờ
modern	hiện_đại
spider	con_nhện
aquarius	bảo_bình
gang	băng_nhóm
pocky	có_gai
zen	thiền_học
specially	đặc_biệt
number	con_số
usa	hoa_kỳ
detox	cai_nghiện
apricot	quả_mơ
consept	thông_minh
destination	nơi_đến
vietnamy	việt_nam
void	vô_hiệu
greek	người_hy_lạp
jackfruit	quả_mít
recommnend	gợi_ý
welcoming	chào_mừng
sunlake	bông_nắng
whelming	tiếng_vo_ve
natural	tự_nhiên
jazcuzzi	bể_sục
this	điều_này
fact	thực_tế
staben	đâm_vào
vaction	kỳ_nghỉ
spotlessley	không_tì_vết
lite	đọc_nhẹ
mousquitos	muỗi
condiciona	lời_chúc_phúc
mom	mẹ
experiencd	kinh_nghiệm
jewel	ngọc
anjoy	vui_mừng
supercheap	siêu_rẻ
unawnsered	không_được_trả_lời
choice	sự_lựa_chọn
hotelexcellent	khách_sạn_tuyệt_vời
scruffy	nhăn_nhó
jacuzy	bể_sục
mistake	sai_lầm
romance	tình_cảm
nuygen	nguyên
additional	bổ_sung
lit	thắp_sáng
vintage	cổ_điển
overwater	trên_mặt_nước
others	khác
valley	thung_lũng
beatufull	xinh_đẹp
website	trang_mạng
spicy	vị_cay
room	phòng
please	xin_vui_lòng
sharing	chia_sẻ
glod	lóng_lánh
absolutely	chắc_chắn_rồi
inflatable	bơm_hơi
decided	quyết_định
stors	cửa_hàng
almond	hạnh_nhân
spaceous	rộng_rãi
ourguide	hướng_dẫn_của_chúng_tôi
homestead	nhà_ở
suong	sương
cooffe	cà_phê
exploring	khám_phá
toys	đồ_chơi
recepcion	sự_tiếp_thu
famous	nổi_danh
hard	cứng
seacond	tàu_biển
manor	trang_viên
conveniences	tiện_nghi
suggest	đề_xuất
badroom	phòng_xấu
department	phòng_ban
indochina	đông_dương
picnic	đi_chơi_picnic
smartwach	đồng_hồ_thông_minh
riverfront	bờ_sông
jubbly	vui_mừng
rocks	đá
hippo	con_hà_mã
planet	hành_tinh
ane	một
trademills	máy_chạy_bộ
forever	mãi_mãi
swan	thiên_nga
promenades	lối_đi_dạo
years	năm
tet	tết
coke	than_cốc
weve	cỏ_dại
afwul	kinh_khủng
lucky	may_mắn
sisters	chị_em_gái
pistachio	hạt_dẻ_cười
tub	bồn_tắm
falls	ngã
barely	vừa_đủ
er	ờ
backdrop	phông_nền
recommendation	sự_giới_thiệu
wellnes	sức_khỏe
vivid	sống_động
reort	sắp_xếp_lại
shoppingtour	đi_du_lịch_mua_sắm
cagle	ca_khúc
backpackers	du_khách_ba_lô
gout	bệnh_gout
inn	quán_trọ
rememberable	có_thể_nhớ_được
corteous	nhã_nhặn
tiger	con_hổ
istay	tôi_ở_lại
geap	nuốt_nước_bọt
threeway	ba_cách
belly	bụng
tung	tùng
statt	trạng_thái
guest	khách_mời
compendiuem	bản_tóm_tắt
trend	khuynh_hướng
locatoion	vị_trí
definate	khử_mùi
remode	làm_lại
trails	đường_mòn
premier	đứng_đầu
passports	hướng_dẫn
brunch	bữa_nửa_buổi
terraces	sân_thượng
brown	nâu
ambiance	môi_trường_xung_quanh
auditor	kiểm_toán_viên
beds	giường_ngủ
asian	châu_á
greet	chào
uno	không
wont	không
umkempt	nhếch_nhác
placesurely	địa_điểm
anchovy	cá_cơm
voted	đã_bình_chọn
swimsuits	đồ_bơi
bye	tạm_biệt
thiem	thiêm
stacious	ngoan_cố
etc	vân_vân
hair	tóc
loking	đang_nhìn
noudles	mì
forth	ra_ngoài
friut	trái_cây
yen	yên
complaint	lời_phàn_nàn
ourself	chính_chúng_ta
kit	bộ_dụng_cụ
we	chúng_tôi
stinks	bốc_mùi
tip	tiền_boa
ancient	cổ_xưa
agradable	nông_nổi
meeting	gặp_gỡ
redcommend	tuyên_dương
photos	ảnh_chụp
urbanhouse	nhà_thành_thị
sue	kiện
nghiem	nghiêm
googlemaps	bản_đồ_google
galaxy	ngân_hà
sailinh	thuyền_buồm
early	sớm
move	di_chuyển
rude	thô_lỗ
fiilling	đổ_đầy
omelette	ốp_lết
beeping	tiếng_bíp
legacy	di_sản
pros	ưu_điểm
recommended	đề_nghị
massager	máy_mát_xa
redy	đỏ_tía
suit	bộ_đồ
sale	giảm_giá
decoration	trang_trí
public	công_cộng
serious	nghiêm_trọng
meal	bữa_ăn
waves	sóng
points	điểm
timesquare	quảng_trường_thời_đại
microwave	lò_vi_sóng
kidsclub	câu_lạc_bộ_trẻ_em
windchimes	chuông_gió
familydinners	bữa_tiệc_gia_đình
written	bằng_văn_bản
recommanded	đề_nghị
concerned	lo_âu
mam	mẹ
christmas	giáng_sinh
tunnels	địa_đạo
ngyugen	nguyên
gdinh	gia_định
allready	tất_cả_đã
hubbub	huyên_náo
souvenir	quà_lưu_niệm
brillient	rực_rỡ
empire	đế_chế
dimly	lờ_mờ
probably	có_lẽ
theif	kẻ_trộm
nachos	bánh_nachos
ridiculously	nực_cười
greeeeeennnnnnn	màu_xanhnnnnnn
eccellent	tuyệt_vời
fooled	bị_lừa
international	quốc_tế
hier	chào
daily	hằng_ngày
breakfeat	bữa_ăn_sáng
future	tương_lai
tuyen	tuyền
sightseeings	điểm_tham_quan
five	số_năm
tolet	hãy_để
ex	ví_dụ
disco	sàn_nhảy
dissapointing	thất_vọng
raccomend	gợi_ý
doesnt	không
excillent	thông_minh
stupid	ngốc_nghếch
dien	điền
flipflops	dép_tông
hen	gà_mái
pictures	những_bức_ảnh
firtsly	đầu_tiên
elite	ưu_tú
several	một_số
tours	chuyến_tham_quan
ranh	ranh_giới
improvement	cải_tiến
loft	căn_hộ_nhỏ
twist	xoắn
lotus	rất_nhiều
vietnamiese	tiếng_việt
giat	con_dê
hello	xin_chào
information	thông_tin
breastfast	thức_ăn_nhanh
marketing	tiếp_thị
breaktime	giờ_giải_lao
riversive	sông
promissed	đã_hứa
plantation	đồn_điền
correct	chính_xác
live	trực_tiếp
extend	mở_rộng
everythink	mọi_suy_nghĩ
car	xe_hơi
beauty	sắc_đẹp,_vẻ_đẹp
ciggies	xì_gà
drew	đã_vẽ
inclus	bao_gồm
tube	ống
experienced	có_kinh_nghiệm
legit	hợp_pháp
wholes	con_điếm
fanastic	cuồng_tín
smel	luyện_kim
soleil	đất
thick	dày
lat	vĩ_độ
amble	đi_thong_thả
solarsystem	hệ_mặt_trời
spaces	dấu_cách
hazelnut	hạt_phỉ
bager	người_đóng_thùng
life	đời_sống
set	bộ
wonderfull	tuyệt_vời
dreams	những_giấc_mơ
weeding	làm_cỏ
rightly	đúng
clubhouse	nhà_câu_lạc_bộ
interested	thú_vị
emtpy	trống
snowy	có_tuyết_rơi
souvenier	vật_lưu_niệm
pandan	lá_dứa
ifriends	bạn_bè
awsome	tuyệt_vời
present	hiện_tại
welcoming	chào_đón
pinnut	hạt_dẻ
mytuor	gia_sư_của_tôi
espessialy	đặc_biệt
guinea	chuột_lang
eclipse	nhật_thực
average	trung_bình_cộng
mumma	mẹ
router	bộ_định_tuyến
summer	mùa_hè
loacation	vị_trí
hummed	ngâm_nga
verry	tươi_vui
beding	đi_ngủ
quoc	quốc
seeview	ngăm_cảnh
gecko	con_tắc_kè
block	khối
complex	phức_tạp
dvd	đĩa_dvd
champagne	rượu_sâm_banh
lightning	tia_chớp
mgr	đức_cha
overrated	đánh_giá_quá_cao
partier	người_chia_tay
shabby	tồi_tàn
gave	đã_cho
unbelievable	không_thể_tin_được
pricerange	phạm_vi_giá
loc	lộc
looking	đang_nhìn
cityit	thành_phố
serviced	phục_vụ
plugin	cắm_vào
feral	hoang_dã
chocol	sô_cô_la
plac	người_khác
tusp	ngà_voi
teambuiding	xây_dựng_nhóm
insane	điên
cuc	dưa_chuột
grandkids	cháu_gái
immerse	đắm
rose	hoa_hồng
hooker	gái_điếm
foriegner	người_nước_ngoài
minded	đầu_óc
tarik	thuế_quan
gieo	gieo_hạt
hottub	bồn_nước_nóng
talkies	người_nói_chuyện
huffed	cáu_kỉnh
kurd	người_kurd
glomad	vui_mừng
ecological	sinh_thái
crap	tào_lao
impolite	vô_lễ
tidy	ngăn_nắp
closeto	gần_với
noise	tiếng_ồn
accomadated	có_chỗ_ở
haven	trú_ẩn
core	cốt_lõi
duong	dương
coco	kén
trekking	leo_núi
stress	nhấn_mạnh
outweighed	vượt_trội_hơn
viking	tên_ông_vua
expected	hy_vọng
cherrys	quả_anh_đào
buon	buôn
here	đây
accommodation	chỗ_ở
screen	màn
my	của_tôi
road	đường
prime	nguyên_tố
aurora	rạng_đông
full	đầy
sower	người_gieo_giống
servives	dịch_vụ
beep	tiếng_kêu_bíp
defenetely	chắc_chắn
worth	đáng_giá
intercontinental	xuyên_lục_địa
telly	truyền_hình
cleaness	sạch_sẽ
roftop	sân_thượng
lilly	hoa_loa_kèn
stellar	thuộc_về_sao
hills	những_ngọn_đồi
spot	nơi
cuing	giám_định
pleasant	hài_lòng
bycicles	xe_đạp
papaya	đu_đủ
corn	ngô
babecue	tiệc_nướng_ngoài_trời
mint	cây_bạc_hà
ladybird	bọ_cánh_cam
fee	học_phí
prder	đặt_hàng
hoast	nâng_cao
backhome	về_nhà
chai	cái_ghế
remants	tàn_dư
leo	sư_tử
emplacement	sự_thay_thế
comofortable	thoải_mái
sized	kích_thước
iced	đóng_băng
plek	cầu_xin
yogurt	sữa_chua
highway	xa_lộ
hotelfriendly	khách_sạn
peach	đào
wanna	muốn
tree	cây
footy	có_chân
bigbus	xe_buýt_lớn
straff	lải_nhải
freestyle	tự_do
getaway	nơi_nghỉ_ngơi
signature	chữ_ký
intercontinental	liên_lục_địa
treehouse	nhà_trên_cây
bday	sinh_nhật
disapointing	thất_vọng
unprovoked	vô_cớ
toan	toàn
available	có_sẵn
east	phía_đông
revisited	đã_duyệt_lại
exqusite	tinh_tế
press	nhấn
caving	hang_động
central	trung_tâm
apanda	một_con_gấu_trúc
sheets	trang_tính
higher	cao_hơn
designed	thiết_kế
burrow	hang_hốc
deserves	xứng_đáng
benifit	có_lợi
accosted	tích_lũy
bra	áo_lót
sunbed	nằm_phơi_nắng
window	cửa_sổ
recetionist	lễ_tân
she	bà_ấy
surperior	cấp_trên
new	mới
ticket	vé
waters	nhiều_nước
quit	thoát
attentive	niềm_nở
places	nơi
ourselves	chính_chúng_ta
something	cái_gì_đó
alquiler	thuật_ngữ
vision	tầm_nhìn
located	nằm
ghotel	con_ma_cà_rồng
tacky	dính_chặt
lot	nhiều
court	tòa_án
squalid	có_vảy
italia	nước_ý
case	trường_hợp
mess	lộn_xộn
pardise	thiên_đường
offsite	ngoại_vi
convention	quy_ước
rendezuvous	điểm_hẹn
sweat	mồ_hôi
ddiscovery	khám_phá
named	được_đặt_tên
ofcoz	tất_nhiên
deal	thỏa_thuận
deffinatley	chắc_chắn
bum	ăn_mày
scaming	lừa_đảo
shock	sốc
pass	vượt_qua
slings	cáp_treo
superfresh	siêu_tươi
unassuming	khiêm_tốn
secure	đảm_bảo
wife	người_vợ
skilled	có_tay_nghề_cao
having	đang_có
lokation	chỗ_ở
teabreak	tiệc_trà
delicious	thơm_ngon
tranquil	yên_tĩnh
mrs	bà
nov	tháng_11
amentities	tiện_nghi
finnegans	người_finnegans
episode	tập_phim
bull	bò_đực
trap	bẩy
told	kể_lại
japenese	tiếng_nhật
cannot	không_thể
sunway	đường_đi_nắng
wonton	hoành_thánh
pruce	cắt_tỉa
restuarants	nhà_hàng
ect	vân_vân
joy	vui_sướng
resault	cướp_lại
executie	người_điều_hành
lilac	tử_đinh_hương
junction	giao_lộ
pretty	đẹp
pro	chuyên_nghiệp
sunshine	ánh_sáng_mặt_trời
pancake	bánh_kếp
brick	gạch
carefull	chăm_sóc_đầy_đủ
prebooked	đặt_trước
impress	gây_ấn_tượng
least	ít_nhất
saves	tiết_kiệm
lost	mất_đi
nom	nôm_na
dine	ăn_cơm_trưa
matress	nệm
boom	bùng_nổ
voucher	phiếu_thưởng
kick	đá
khuya	đêm_nay
bedbugs	rệp
acceptable	chấp_nhận_được
log	nhật_ký
lazing	buồn_ngủ
sakura	hoa_anh_đào
asap	càng_sớm_càng_tốt
nirvana	niết_bàn
address	địa_chỉ
tiep	tiệp
tie	cà_vạt
outstandig	nổi_bật
truely	thực_sự
wallop	bức_tường
crocodile	cá_sấu
backpackerville	ba_lô
continue	tiếp_tục
motorbike	xe_máy
talk	nói_chuyện
coconut	dừa
surise	bình_minh
prises	mồi
tatty	rách_nát
really	có_thật_không
xui	xui_xẻo
precious	quí
taiwan	đài_loan
wine	rượu
during	suốt_trong
seahors	cá_ngựa
heat	nhiệt
bear	chịu
aircond	điều_hòa
belive	tin_tưởng
servicea	dịch_vụ
chest	ngực
buffolo	trâu
horrors	kinh_dị
nerver	thần_kinh
rural	nông_thôn
extreme	cực
parc	bưu_kiện
russian	tiếng_nga
chanh	chánh
director	giám_đốc
photoshopper	người_chụp_ảnh
awesom	tuyệt_vời
pan	cái_chảo
advance	nâng_cao
coacroaches	con_gián
poolside	bên_hồ_bơi
staffs	nhân_viên
toasters	lò_nướng_bánh_mì
card	thẻ
quartier	người_khai_hoang
balloon	quả_bóng_bay
drink	uống
howls	tiếng_hú
lakside	bờ_hồ
ginormous	to_lớn
smmel	cười_khẩy
toielt	phòng_vệ_sinh
breakffast	bữa_ăn_sáng
award	giải_thưởng
cokes	than_cốc
viet	việt
australia	châu_úc
job	việc_làm
peanut	đậu_phụng
western	miền_tây
lakeside	bờ_hồ
dearest	thân_yêu_nhất
mother	mẹ
restaraunt	nhà_hàng
oldies	người_già
absoluteparadise	tuyệt_đối
accor	tố_cáo
foret	báo_trước
whales	cá_voi
heck	quái
duvet	chăn_bông
regal	quốc_vương
sep	tháng_chín
serioulsly	nghiêm_túc
fajitas	cà_ri
backagge	quay_ngược_lại
bugalow	nhà_gỗ
noddles	gật_gù
peninsula	bán_đảo
higly	cao_cấp
knowlegable	có_kiến_​​thức
ngonthanks	ngoncảm_ơn
ownwer	chủ_nhân
cinema	rạp_chiếu_phim
cheer	vui_lên
limestone	đá_vôi
unfriedly	không_thân_thiện
rate	tỷ_lệ
iight	ánh_sáng
foam	bọt
news	tin_tức
wont	sẽ_không
thoughtful	chu_đáo
beofe	trước
banquit	yến_tiệc
equipment	trang_thiết_bị
sideroad	lề_đường
masterstroke	cột_buồm
hills	đồi_núi
oreint	định_hướng
santa	ông_già_noel
pedestrian	người_đi_bộ
acacia	cây_keo
hideaways	nơi_ẩn_náu
addon	thêm_vào
distub	làm_phiền
dthoai	điện_thoại
nonchalant	hờ_hững
welcomerink	chào_mừng
majestic	hùng_vĩ
bluebell	chuông_xanh
scams	lừa_đảo
vinearl	cây_nho
brekfast	bữa_sáng
lesson	bài_học
agood	tốt
keep	giữ
escapes	chạy_trốn
especcialy	đặc_biệt
reply	đáp_lại
relationship	mối_quan_hệ
sanitair	nhà_vệ_sinh
confirmation	xác_nhận
trash	rác
infact	trong_thực_tế
cub	đàn_con
oakwood	gỗ_sồi
personell	nhân_viên
perssonnel	nhân_viên
machine	máy_móc
hostels	ký_túc_xá
propper	thợ_săn
ecean	đại_dương
changes	thay_đổi
couldnt	không_thể
duyen	duyên
ede	ê_đê
strees	nhấn_mạnh
shearing	cắt_xén
voidable	vô_hiệu
weasal	chồn
impressed	ấn_tượng
feast	tiệc
kieu	kiều
satisfied	hài_lòng
fabulious	tuyệt_vời
bamboo	cây_tre
appreciation	sự_đánh_giá
fisrt	đầu_tiên
directeur	người_trực_tiếp
know	biết_rôi
heloful	hữu_ích
almost	hầu_hết
receptionists	lễ_tân
pork	thịt_heo
ferris	đu_quay
warmth	sự_ấm_áp
phu	phú
breifs	tóm_tắt
penthouse	căn_hộ_áp_mái
frontside	mặt_trước
lantarns	đèn_lồng
servic	dịch_vụ
restaurants	các_nhà_hàng
met	gặp
karma	nghiệp
managed	quản_lý
cricket	bóng_chày
conditional	có_điều_kiện
following	tiếp_theo
jantle	đùa_giỡn
tgeir	của_chúng
considering	đang_cân_nhắc
lobster	tôm
bare	trần
freebies	tiền_thưởng
mistakes	những_sai_lầm
caption	chú_thích
thnks	cảm_ơn
cheep	chim_kêu
soccer	bóng_đá
dinning	ăn_tối
stairwell	cầu_thang
filght	chuyến_bay
vibes	rung_cảm
unenthusiastic	không_nhiệt_tình
stick	gậy
finish	hoàn_thành
canyouning	đường_hầm
corredor	thợ_sửa_xe
mugs	cốc
convenient	tiện_lợi
welldone	làm_tốt
againi	một_lần_nữa_tôi
absolute	tuyệt_đối
ethusiasim	hăng_hái
pavilion	gian_hàng
care	quan_tâm
knowledgeable	có_kiến_​​thức
hotspring	suối_nóng
roomservice	dịch_vụ_phòng
aquafeed	thức_ăn_thủy_sản
chekin	đăng_ký_vào
drivers	trình_điều_khiển
befind	tìm_kiếm
june	tháng_sáu
hero	anh_hùng
breskfast	bữa_ăn_sáng
stanards	tiêu_chuẩn
doule	lừa_đảo
track	theo_dõi
bigman	người_đàn_ông_to_lớn
gorgeously	lộng_lẫy
middle	ở_giữa
baquettes	bánh_mì_baguette
icecold	đá_lạnh
loving	thương
sera	huyết_thanh
que	xếp_hàng
map	bản_đồ
tkanks	cảm_ơn
paddy	thóc
looked	đã_nhìn
russiana	tiếng_nga
dollar	đô_la
wood	gỗ
story	câu_chuyện
revirew	ôn_tập
bitexco	cắnxco
chillbox	thùng_lạnh
treatment	sự_đối_xử
nextdoor	cánh_cửa_tiếp_theo
done	làm_xong
reprieve	ân_hận
dormy	ngủ_đông
excilent	đặc_biệt
trips	chuyến_đi
durty	bẩn_thỉu
temple	ngôi_đền
laudry	giặt_ủi
upselling	lên_bán
sucessfull	thành_công
travellimg	đi_du_lịch
shampoo	dầu_gội_đầu
chinatown	khu_phố_tàu
way	đường
relaxing	thư_giãn
hilarious	vui_nhộn
actualy	thực_tế
sealink	con_dấu
descibe	diễn_tả
inconvinience	sự_bất_tiện
lock	khóa
towards	hướng_tới
rats	chuột_cống
hyped	hóa
unit	đơn_vị
gate	cánh_cổng
anonimous	vô_danh
led	dẫn_đầu
order	đặt_hàng
prefabricados	nhà_tiền_chế
waterline	dòng_nước
exceptional	đặc_biệt
hem	viền
falcility	sự_giả_dối
without	không_có
tuong	tường
buffalo	trâu
lookwise	nhìn_kỹ
strawhat	mũ_rơm
exciting	thú_vị
terrace	sân_thượng
ideal	lý_tưởng
computer	máy_vi_tính
conf	tâm_sự
upsell	bán_lại
resot	tiếng_vang
pet	vật_nuôi
ivy	cây_thường_xuân
opertunity	dịp_tốt
pasta	mỳ_ống
compact	gọn_nhẹ
english	tiếng_anh
hop	nhảy_lò_cò
title	tiêu_đề
pasword	mật_khẩu
disovery	khám_phá
drivers	tài_xế
baby	đứa_bé
rides	cưỡi_ngựa
cottages	trang_trại
stoipped	bị_đánh_cắp
pumpkin	quả_bí_ngô
languange	ngôn_ngữ
woo	gâu_gâu
freey	chiếc_phà
roof	mái_nhà
seagull	hải_âu
springrolls	chả_giò
vacances	kỳ_nghỉ
include	bao_gồm
relaxed	thư_thái
rosemarry	cây_mê_điệt
citypoint	điểm_thành_phố
pingpong	bóng_bàn
prince	hoàng_tử
spoiler	làm_hư_hỏng
seminar	hội_thảo
purpose	mục_đích
fue	chết_tiệt
reallly	có_thật_không
friedly	chiên
worlde	lo_lắng
polite	lịch_sự
cap	mũ_lưỡi_trai
rep	đại_diện
wed	thứ_tư
standar	độc_lập
favorite	yêu_thích
couple	cặp_đôi
sandwitch	bánh_mì_kẹp
clea	chẻ_đôi
fortune	vận_may
terra	ruộng_bậc_thang
funfact	sự_thật_thú_vị
habitaciones	thói_quen
calm	điềm_tĩnh
hustle	hối_hả
from	từ
unacceptable	không_thể_chấp_nhận_được
jet	máy_bay_phản_lực
anniversary	ngày_kỷ_niệm
sont	không
stile	cứng_nhắc
migra	di_cư
condo	căn_hộ
butffet	tiệc_đứng
personnel	nhân_viên
roofbar	thanh_mái
recommendso	giới_thiệu
helpfulbuffet	hữu_ích
cleaned	làm_sạch
dingy	bẩn_thỉu
numberone	số_một
one	một
rooptop	sân_thượng
wanted	muốn
reosrt	phương_sách
especial	đặc_biệt
bawdyhouse	nhà_bawdyhouse
niggle	cười_đùa
start	khởi_đầu
masseur	người_xoa_bóp
body	thân_hình
there	đó
fovourite	yêu_thích
date	ngày
landmarket	thị_trường_nhà_đất
hostle	nhà_trọ
hamburger	bánh_hamburger
befast	nhanh_lên
his	của_anh_ấy
employee	nhân_viên
prace	lời_chúc_tụng
bouns	giới_hạn
duty	nhiệm_vụ
plase	làm_ơn
although	mặc_du
bunaglow	nhà_gỗ
event	biến_cố
bittet	đắng
reaction	phản_ứng
beside	bên_cạnh
somethings	một_số_điều
horrified	đã_xác_nhận
what	gì
introduce	giới_thiệu
gas	khí_ga
nicely	độc_đáo
damp	ẩm_ướt
chagre	sạc_điện
records	hồ_sơ
chili	ớt
expressthanks	bày_tỏ_sự_cảm_ơn
exentent	hiện_tại
brandy	rượu_mạnh
overal	nói_quá
theives	kẻ_trộm
redoing	làm_lại
world	thế_giới
members	các_thành_viên
vinosis	vi_chứng
artisan	nghệ_nhân
opption	sự_chống_đối
coathangers	áo_choàng
package	gói_hàng
coworking	làm_việc_chung
net	mạng_lưới
choices	sự_lựa_chọn
tirant	bậc_thang
guyssss	thằng_khốn
their	của_chúng
thief	tên_trộm
jun	tháng_sáu
led	đèn_led
missall	bỏ_lỡ_tất_cả
serenaded	theo_dõi
quarte	cãi_nhau
crowning	vương_miện
bag	túi
swim	bơi
minifridge	tủ_lạnh_nhỏ
threeday	ba_ngày
enthusiam	hăng_hái
motorcycles	xe_máy
bistro	quán_rượu
quac	quắc
lifeguard	nhân_viên_cứu_hộ
memories	kỉ_niệm
scammer	kẻ_lừa_đảo
tue	thứ_ba
chiang	tưởng
bedlinen	khăn_trải_giường
works	làm
impersonal	nhân_cách
helpfully	hữu_ích
adjacebt	liền_kề
adiacent	liền_kề
copycats	bắt_chước
cheerful	vui_lòng
fourth	thứ_tư
marvrllous	kỳ_diệu
hitea	xin_chào_trà
upper	phía_trên
moved	đã_di_chuyển
minuses	số_phút
warmth	ấm_áp
aroma	mùi_thơm
awaful	kinh_khủng
pick	hái
raintime	thời_gian_raintime
drap	khăn_trải_giường
wall	tường
corny	xưa
cell	ô
korea	hàn_quốc
riceflower	hoa_gạo
hazardous	nguy_hiểm
lea	đồng_cỏ
walk	đi_bộ
saparate	tách_rời
surfingwinds	lướt_sóng
marvelous	kỳ_diệu
teiple	gấp_ba
ampenities	quần_thể
conect	hình_nón
dreamers	những_người_mơ_mộng
arbitrarily	tùy_tiện
next	kế_tiếp
lugggae	hành_lý
reservation	dự_phòng
prepping	sơ_chế
owners	những_chủ_sở_hữu
resident	cư_dân
duluxe	sang_trọng
mister	quí_ông
ears	đôi_tai
lane	làn_đường
cosmopolitan	khắp_thế_giới
pop	bật_ra
chain	chuỗi
especially	đặc_biệt
quanhtuy	quánh
designing	thiết_kế
unpack	giải_nén
minor	diễn_viên_phụ
serenity	thanh_thản
sepia	màu_nâu_đỏ
exuses	lời_bào_chữa
lien	quyền_cầm_giữ
surrounded	được_bao_quanh
drinks	đồ_uống
direct	thẳng_thắn
visited	đã_đến_thăm
terms	điều_kiện
issue	vấn_đề
moody	buồn_rầu
trees	cây
fday	thứ_hai
newway	cách_mới
staps	đinh_ghim
meesting	yêu_cầu
cancel	hủy
punctuality	đúng_giờ
grace	ân_huệ
khau	khẩu
list	danh_sách
sigarette	thuốc_lá
strong	mạnh
vietnamese	tiếng_việt
xao	xao_xuyến
aviod	tránh
electric	điện
tatto	hình_xăm
vin	sơ_vin
planner	người_lập_kế_hoạch
englisheverything	tiếng_anh
exercise	tập_thể_dục
rudest	thô_lỗ
seahose	cá_ngựa
buidling	xây_dựng
them	chúng
site	địa_điểm
special	đặc_biệt
lluggage	hành_lý
legend	huyền_thoại
when	khi_nào
hanging	treo_cổ
crash	tai_nạn
puking	nôn_mửa
claimed	tuyên_bố
arent	không
houskeeping	dọn_phòng
bags	túi
smothie	sinh_tố
accidently	tình_cờ
horror	kinh_dị
highchairs	ghế_cao
scammed	bị_lừa_đảo
allowed	được_phép
progressive	cấp_tiến
every	mỗi
serviec	dịch_vụ
bussy	bận_rộn
milkyway	dải_ngân_hà
kingdom	vương_quốc
maneger	người_điều_khiển
conifer	hạt_trần
blaring	bùng_nổ
condicioned	có_điều_kiện
upgrage	nâng_cấp
kiwi	quả_kiwi
residencia	cư_xá
exigences	sự_xuất_hiện
diamond	kim_cương
reason	lý_do
bellhop	cửa_hàng_chuông
teambuiding	xây_dựng_đội_ngũ
month	tháng
arigant	kiêu_ngạo
chekout	thủ_tục_thanh_toán
recommand	lời_nhắc_nhở
freaking	quái_đản
grend	màu_xám
business	kinh_doanh
budget	ngân_sách
bugdet	ngân_sách
doorgil	khung_cửa
instructions	hướng_dẫn
cocc	con_ông_cháu_cha
whew	tiếng_kêu
scamming	lừa_đảo
happys	hạnh_phúc
clases	hợp_lại
beepub	bíp_bíp
ultimate	tối_thượng
casino	sòng_bạc
funemployment	thiếu_việc_làm
assign	chỉ_định
holidaymoon	kỳ_nghỉ
disputable	không_thể_tranh_cãi
toilletries	đồ_vệ_sinh_cá_nhân
green	màu_xanh_lá
made	thực_hiện
bourbon	rượu_whisky_ngô
washlet	nhà_vệ_sinh
area	khu_vực
ghen	ghen_tị
upthere	trên_đó
ham	giăm_bông
ancent	đi_lên
villages	làng
nomadder	nôm_na
canyoneering	người_đóng_hộp
beatiful	đẹp
nontheless	dù_sao_thì
calculate	tính_toán
been	đã
squid	mực_ống
nostalgia	hoài_cổ
grotty	sự_thô_lỗ
hideaway	ẩn_đi
hii	xin_chào
recoment	giới_thiệu
smacked	đánh_lén
whils	đánh_trống_lảng
breakfirst	đột_phá
unavailable	không_có_sẵn
proffesional	chuyên_nghiệp
helfull	hữu_ích
leave	rời_khỏi
warning	cảnh_báo
complained	phàn_nàn
overalla	quần_yếm
firefly	con_đom_đóm
primer	lót
crepes	bánh_crếp
biffet	tiệc_đứng
combo	kết_hợp
group	nhóm
xuan	xuân
par	ngang_bằng
luxery	xa_xỉ
collor	người_cắt_dán
tropic	chí_tuyến
overcharged	quá_mức
ice	nước_đá
enegergy	năng_lượng
smothies	bánh_kẹo
establishment	thành_lập
goood	tốt
oceam	đại_dương
tradeoff	sự_đánh_đổi
ecellent	thông_minh
upon	trên
increasing	tăng
tailor	thợ_may
resrost	nối_lại
cleadly	khôn_ngoan
honk	bấm_còi
singing	ca_hát
nite	đêm
yup	vâng
cuteeee	dễ_thương
shorting	rút_ngắn
repeated	lặp_đi_lặp_lại
matsa	thảma
reccommended	đề_nghị
sinserely	trân_trọng
dodgey	né_tránh
nightcap	mũ_ngủ
amazimg	kinh_ngạc
fake	giả_mạo
bufffet	tiệc_đứng
plat	tấm_ván
templing	cám_dỗ
reception	lễ_tân
us	chúng_ta
comfotable	thoải_mái
sleep	ngủ
plasters	trát_tường
uppet	đoạn_mã
beakfast	bữa_sáng
enthusiasm	hăng_hái
whynot	tại_sao_không
reataurant	nhà_hàng
beachfront	bờ_biển
lead	chì
mouth	mồm
enjoyed	rất_thích
afraid	sợ
looker	người_nhìn
friendlybut	thân_thiện_nhưng
race	cuộc_đua
getaroom	nhận_phòng
dedicated	chuyên_dụng
experiance	kinh_nghiệm
cristmas	giáng_sinh
copped	che_đậy
thannks	cảm_ơn
branch	chi_nhánh
olive	ôliu
disspointed	thất_vọng
everuthing	mọi_điều
goatmeat	thịt_dê
haapy	vui_mừng
culinar	người_nói_chuyện
suspendre	dây_treo
graffiti	vẽ_tranh_lên_tường
freeeee	miễn_phí
cham	chăm
downstair	tầng_dưới
ecologic	sinh_thái_học
pankcakes	bánh_xèo
aug	tháng_8
give	đưa_cho
boardwalk	lối_đi_lát_ván
child	đứa_trẻ
fro	sương_giá
detailed	chi_tiết
killing	giết
regional	khu_vực
containing	chứa_đựng
recidence	nơi_cư_trú
appartment	căn_hộ
abysmal	vực_thẳm
alothough	mặc_du
starcity	sự_khan_hiếm
transport	vận_chuyển
brige	bờ_vực
recomendation	sự_giới_thiệu
suitable	thích_hợp
nhut	nhựt
freezer	tủ_đông
denmark	đan_mạch
lame	què
salvation	sự_cứu_rỗi
vientiane	viêng_chăn
allure	quyến_rũ
salon	thẩm_mỹ_viện
dont	không
notch	khía
gob	ngấu_nghiến
lheritage	di_sản
option	lựa_chọn
excellemt	thông_minh
despues	khinh_thường
seashore	bờ_biển
christian	cơ_đốc_giáo
fruite	trái_cây
dormbeds	giường_ngủ_tập_thể
beyobd	vượt_ra_ngoài
ricewine	rượu_gạo
select	lựa_chọn
trong	trọng
loads	tải
plan	kế_hoạch
ditto	như_trên
comfy	thoải_mái
signposted	biển_chỉ_dẫn
sweethouse	căn_nhà_dễ_thương
doorhandle	tay_nắm_cửa
hibiscus	dâm_bụt
banana	trái_chuối
cahoots	móc_ngoặc
disapponting	khai_thác
sunchair	ghế_tắm_nắng
pefect	hoàn_hảo
positifs	dương_tính
toaster	máy_nướng_bánh_mì
reastaurants	nhà_hàng
lao	lào
expencive	khai_khẩn
reed	cây_lau
risemount	tăng_lên
matday	ngày_tháng_năm
bathroon	phòng_tắm
cantho	cần_thơ
beatiful	đẹp_đẽ
girls	các_cô_gái
rati	tỷ_lệ
gap	lỗ_hổng
refill	đổ_đầy
came	đã_đến
paying	trả_tiền
blessing	ban_phước
beautyful	đẹp_đẽ
smiling	mỉm_cười
cheeper	chim_kêu
days	ngày
chillax	làm_lạnh
rot	thúi
smelly	hôi
upgrade	nâng_cấp
hai	hải
once	một_lần
turndown	giảm_xuống
hosstes	bà_chủ
glanced	liếc
theme	chủ_đề
recommented	đề_nghị
now	hiện_nay
finest	tốt_nhất
assistant	phụ_tá
easier	dễ_dàng_hơn
triple	gấp_ba
pitch	sân_cỏ
paramount	tối_quan_trọng
lactose	đường_lactose
investigates	điều_tra
ten	mười
extrabed	giường_phụ
complete	hoàn_thành
between	giữa
reviews	đánh_giá
expecially	đặc_biệt
leg	chân
locations	địa_điểm
smoking	hút_thuốc
batter	bột_nhồi
finally	cuối_cùng
nightthe	ban_đêm
dirtiness	bẩn_thỉu
hil	xin_chào,_tôi
rottening	thối_rữa
close	đóng
affordable	giá_cả_phải_chăng
exped	thám_hiểm
friendlytake	thân_thiện
nigth	đêm
aud	thử_giọng
essence	bản_chất
dam	đập
allows	cho_phép
certainty	chắc_chắn
voyage	hành_trình
hotpot	lẩu
beautifully	đẹp_đẽ
daytrippers	ngày_của_người_du_ngoạn
beachhouse	nhà_ở_bờ_biển
foods	thức_ăn
veitnam	việt_nam
underdtand	hiểu_biết
showing	hiển_thị
ido	tôi_làm
fiore	tốt
greenery	cây_xanh
vitenamise	tiếng_việt
devine	nuốt_chửng
escape	bỏ_trốn
beutiful	đẹp
them	họ
modernization	hiện_đại_hóa
booked	đã_đặt_trước
breaklfast	bữa_ăn_sáng
platfrorm	nền_tảng
bath	bồn_tắm
discover	khám_phá
mosquito	con_muỗi
suttle	kinh_sư
appreciable	đáng_trân_trọng
tran	trần
microphone	cái_mic_cờ_rô
culture	văn_hóa
badge	huy_hiệu
initially	ban_đầu
conference	hội_nghị
homesta	nhà_trọa
restarunt	nhà_hàng
being	hiện_hữu
queensize	cỡ_lớn
kangaroo	con_chuột_túi
realized	nhận_ra
avaible	có_sẵn
brandlaureate	nhãn_hiệu
intercontinal	xuyên_lục_địa
overprized	quá_nhiều
goup	đi_lên
forniture	đồ_đạc
nooddle	bún
hometsay	ở_nhà_người_bản_xứ
decently	đoan_trang
private	riêng_tư
contras	trái_ngược
elavator	thang_máy
drikke	nhỏ_giọt
insideview	quang_cảnh_bên_trong
aircon	máy_bay
havea	có_một
lieu	thay_vì
spring	mùa_xuân
homestyle	kiểu_nhà
jaccuzzi	bể_sục
failed	thất_bại
overnigth	qua_đêm
tilasin	cá_rô_phi
layout	bố_trí
fwd	dâm_đãng
goal	mục_tiêu
hooting	nâng_đỡ
twins	sinh_đôi
shape	hình_dạng
confortably	thoải_mái
charging	sạc
professionnalisme	nghề_nghiệp
strip	dải
bungallow	nhà_gỗ
vein	tĩnh_mạch
earsy	có_tai
gopro	đi_pro
chit	chít
army	quân_đội
raining	mưa
exhausted	kiệt_sức
fount	đài_phun_nước
vietnames	tiếng_việt
halong	dài
libra	thiên_bình
pricier	đắt_hơn
choicing	sự_lựa_chọn
camon	cảm_ơn
vali	dũng_cảm
satyed	đã_ở_lại
dress	trang_phục
disappointing	thất_vọng
sniff	bị_nghẹt_mũi
keyless	không_chìa_khóa
conditioning	điều_hòa
feedback	phản_hồi
markdown	đánh_dấu
ill	tôi_sẽ
perk	thù_lao_thêm
seedy	có_nhiều_hạt
amenite	đá_thạch_anh
cash	tiền_mặt
extra	thêm
antidote	thuốc_giải_độc
end	kết_thúc
unoccupied	không_có_người_ở
monkey	con_khỉ
iris	mống_mắt
trusting	tin_tưởng
bangkokian	người_bangkok
starfruit	trái_khế
corona	hào_quang
roomsbeachpool	phòng_tắm
jaunt	đi_chơi
damn	chỉ_trích
toast	bánh_mì_nướng
eaxample	thí_dụ
catheral	ống_thông
impressions	số_lần_hiển_thị
scandinavi	bán_đảo_scandinavia
birdhouse	chuồng_chim
lagoon	đầm_phá
residences	khu_dân_cư
veri	xác_minh
lake	hồ_nước
resorts	khu_nghỉ_dưỡng
ratng	xếp_hạng
awkward	khó_xử
discorvery	khám_phá
snug	ấm_áp
else	khác
overpriced	quá_đắt
defonitely	chắc_chắn
worlcup	cúp_thế_giới
varied	đa_dạng
doreamon	đôrêmon
beef	thịt_bò
cat	con_mèo
roomgreat	phòng_lớn
greenaway	cây_xanh
cocacola	cô-ca_cô-la
tap	gõ_nhẹ
sunset	hoàng_hôn
toll	thu_phí
happys	xảy_ra
xoan	cây_xoan
sac	túi
sentir	lính_gác
entrace	cuốn_theo
lie	nói_dối
smelt	thơm
lab	phòng_thí_nghiệm
dean	trưởng_khoa
indigo	xanh_đậm
reading	đọc_hiểu
pain	đau_đớn
tips	lời_khuyên
whit	ý_thích
housekeep	quản_gia
mtr	triệu
shell	vỏ_sò
stuff	đồ_đạc
juice	nước_ép
jacky	chó_rừng
springs	lò_xo
landscapes	phong_cảnh
person	người
particulares	chi_tiết
thon	thon_gọn
bancony	ban_công
sank	chìm
compfortable	thoải_mái
laureate	người_đoạt_giải
cothe	có_thể
university	trường_đại_học
raving	say_sưa
whenever	bất_cứ_khi_nào
albiet	mặc_dù
clay	đất_sét
caps	mũ_lưỡi_trai
patio	sân_trong
desetved	được_yêu_thích
steal	lấy_trộm
byes	tạm_biệt
sunday	chủ_nhật
ptoperty	bất_động_sản
silent	im_lặng
sheet	tấm
got	có
euthusiastic	nhiệt_tâm
boys	những_cậu_bé
pasports	hộ_chiếu
mediocre	tầm_thường
homey	ấm_cúng
incheck	trong_kiểm_tra
snorkelling	lặn_với_ống_thở
chin	cái_cằm
resport	hô_hấp
uncomfortable	khó_chịu
radio	đài
quieres	run_rẩy
incl	bao_gồm
tou	bạn
watch	đồng_hồ_đeo_tay
roomie	phòng_trọ
delightful	thú_vị
pohled	phập_phồng
busy	bận
veey	rất
urhome	nhà_của_em
ngai	ngãi
informacion	thông_tin
let	để_cho
familia	quen_thuộc
overpriced	định_giá_quá_cao
cobran	rắn_hổ_mang
puppies	bố_cục
goodbye	tạm_biệt
slice	lát
beverage	đồ_uống
fisher	người_câu_cá
refshuffled	nhồi_lại
ricefield	ruộng_lúa
alleyway	ngõ
strange	kỳ_lạ
rarely	ít_khi
hovever	tuy_nhiên
rooming	phòng_trọ
crawl	thu_thập_thông_tin
another	khác
lash	dây_da_roi
ant	con_kiến
carey	cẩn_thận
crown	vương_miện
tuibg	kéo_mạnh
bedside	phòng_ngủ
lords	lãnh_chúa
moneys	tiền
piizzas	bánh_pizza
hotelfriendly	thân_thiện
pickup	nhặt_lên
brecky	rượu_bia
bush	cây_bụi
profesionnal	chuyên_nghiệp
simply	đơn_giản
tidied	ngăn_nắp
tuesday	thứ_ba
dealtoday	xử_lý_ngày_hôm_nay
fengshui	phong_thủy
passion	niềm_đam_mê
laurel	nguyệt_quế
hamlet	ấp
ware	đồ
actually	thực_ra
sanctuary	thánh_địa
aweful	kinh_hoàng
jesus	chúa_giê-xu
april	tháng_tư
orat	hoặc_tại
cousy	anh_em_họ
thieu	thiệu
mutiple	bội_số
helfpul	hữu_ích
giantuyet	người_khổng_lồ
cog	răng_cưa
roses	hoa_hồng
bedbugs	giường_ngủ
espresso	cà_phê_espresso
ngan	ngân
frig	gàn
yam	mứt
seastar	sao_biển
sauna	tắm_hơi
cuc	cúc
cherish	trân_trọng
faulty	bị_lỗi
change	thay_đổi
stinks	liên_kết
mountan	núi
termina	chấm_dứt
scootering	loang_lổ
comfertble	thoải_mái
straight	thẳng
voucher	chứng_từ
fritters	khoai_tây_chiên
flop	thất_bại
dishing	món_ăn
dusted	phủi_bụi
claim	yêu_cầu
snorkel	ống_thở
barisra	thợ_pha_cà_phê
notre	dấu_vết
salt	muối
fruut	trái_cây
sport	thể_thao
doenst	không
bazaar	chợ
offered	cung_cấp
down	xuống
mytv	tv_của_tôi
risemount	số_tiền_rủi_ro
sunline	dải_nắng
humble	khiêm_tốn
takes	nhận
tourist	du_lịch
unbelievably	không_tin
engish	tiếng_anh
deathtrap	cái_chết
lonely	cô_đơn
seafront	bờ_biển
junior	trẻ_em
inconveneicne	sự_bất_tiện
girl	con_gái
japan	nhật_bản
cons	nhược_điểm
buddha	đức_phật
bearable	có_thể_chịu_được
somtime	thỉnh_thoảng
passionfruit	chanh_dây
chic	sang_trọng
biketour	chuyến_đi_bằng_xe_đạp
refrigerator	tủ_lạnh
history	lịch_sử
stark	ngay_đơ
thro	xuyên_qua
alo	a_lô
fail	thất_bại
especillay	đặc_biệt
moove	di_chuyển
atosphere	không_khí
health	sức_khỏe
snail	ốc_sên
spent	bỏ_ra
training	đào_tạo
vietnameese	tiếng_việt
acces	truy_cập
distubed	bị_làm_phiền
neon	đèn_neon
ambience	môi_trường_xung_quanh
niceee	tốt_đẹp
skewers	xiên_que
pearl	ngọc_trai
tattoo	xăm_hình
myth	thần_thoại
bookingservice	dịch_vụ_đặt_chỗ
neighboor	hàng_xóm
hillside	sườn_đồi
martket	thị_trường
tap	nhấn_vào
higland	cao_nguyên
insist	năn_nỉ
board	bảng
hoisin	nước_tương_đen
atrium	tâm_nhĩ
unplesaent	không_tiết_kiệm
foodie	người_ăn_uống
kings	các_vị_vua
beacg	bờ_biển
chopsticks	đũa
pullup	kéo_lên
pullman	người_kéo
infinitive	nguyên_mẫu
basic	căn_bản
minusside	điểm_trừ
royality	hoàng_gia
idyll	cảnh_đồng_quê
any	bất_kì
peeps	nhìn_trộm
correos	tương_quan
dreaming	đang_mơ
marigold	cúc_vạn_thọ
keycard	thẻ_chìa_khóa
agrafirt	váy_ngắn
barista	thợ_pha_cà_phê
sense	giác_quan
hustling	hối_hả
romms	lãng_mạn
thin	gầy
gardens	vườn
jeans	quần_jean
massge	mát_xa
moonrise	mặt_trăng
zin	đồ_zin
flame	ngọn_lửa
merit	n:_xứng_đáng
evason	bao_giờ
adamant	cương_quyết
fragrance	mùi_thơm
our	của_chúng_tôi
herb	thảo_mộc
mood	tâm_trạng
skylounge	phòng_chờ_bay
dest	đích
blare	chói_lọi
newish	mới_mẻ
paracel	hoàng_sa
definetley	chắc_chắn
seashells	vỏ_sò
own	sở_hữu
manger	máng_cỏ
corse	thô
enjo	ra_lệnh
ocidental	tình_cờ
minus	dấu_trừ
tiet	tiết
soft	mềm_mại
months	tháng
rew	phần_thưởng
micro	vi_mô
pianist	nghệ_sĩ_piano
ropey	dây_thừng
cliff	khách_hàng
tranquility	yên_bình
pitty	hầm_hố
west	hướng_tây
footbath	bồn_rửa_chân
alright	ổn_thỏa
restyling	nghỉ_ngơi
kettle	ấm_đun_nước
perfecly	hoàn_hảo
soonest	sớm_nhất
transit	quá_cảnh
emotion	cảm_xúc
thua	thừa
ueen	thiếu_niên
bliss	phúc_lạc
poem	bài_thơ
disclaimer	khước_từ
stop	dừng_lại
lighttube	ống_đèn
fire	ngọn_lửa
canceling	hủy_bỏ
hotes	nhiều_khách_sạn
hotle	khách_sạn
transprt	vận_chuyển
accoustic	âm_thanh
persona	cá_tính
smack	đập
sniper	kẻ_bắn_tỉa
womans	phụ_nữ
suburban	ngoại_ô
aficionado	người_cuồng_nhiệt
gro	trưởng_thành
croplife	cây_trồng
typhoon	bão_nhiệt_đới
quyen	quyên
cocoon	cái_kén
horizn	chân_trời
archer	người_bắn_cung
avos	trái_bơ
cofffee	cà_phê
oustanding	nổi_bật
minute	phút
setvice	dịch_vụ
yes	đúng
apartemnts	chung_cư
addition	thêm_vào
pubes	quán_rượu
lum	tùm_lum
hao	hảo
reastaurnt	nhà_hàng
totally	tổng_cộng
key	chìa_khóa
accomadation	chỗ_ở
pisatchio	hạt_dẻ_cười
townhouse	nhà_phố
something	ngươi
travelbox	hộp_du_lịch
resrt	phương_sách
janky	vui_vẻ
thung	thung_lũng
firework	pháo_hoa
agency	đại_lý
ticks	tích_tắc
check	kiểm_tra
thubg	côn_đồ
proactively	chủ_động
breaktfast	bữa_ăn_sáng
tourguide	hướng_dẫn_viên_du_lịch
late	muộn
convenience	tiện
caveat	cảnh_báo_trước
four	bốn
angle	góc
message	thông_điệp
tukish	thổ_nhĩ_kỳ
girls	con_gái
trust	lòng_tin
dusty	bụi_bặm
corral	chuồng_ngựa
teatching	giảng_bài
duey	đến_hạn
echoing	tiếng_vang
coocked	nấu_chín
deposit	tiền_gửi
anemities	tiện_nghi
field	cánh_đồng
superseeds	hạt_siêu
kiting	ăn_thịt
oceanview	đại_dương
returning	trở_về
threw	ném
friensdly	phù_phiếm
translated	đã_dịch
pines	cây_thông
delta	đồng_bằng
bikerental	cho_thuê_xe_đạp
reset	cài_lại
click	nhấp_chuột
breakfadt	bữa_ăn_sáng
jesus	chúa_giêsu
boat	thuyền
thot	thốt_nốt
took	lấy
resrurant	nhà_hàng
taximeter	máy_đo_thuế
locatiom	vị_trí
jetstar	sao_phản_lực
breakkfast	bữa_ăn_sáng
silence	im_lặng
wowed	kinh_ngạc
riverwalk	đường_ven_sông
mopeds	xe_gắn_máy
goodluck	chúc_may_mắn
enouh	đủ
better	tốt_hơn
bicyle	xe_đạp
chose	đã_chọn
atmosphere	không_khí
helpfull	hữu_ích
self	bản_thân
airway	khí_đạo
ingredients	thành_phần
frienldy	thân_thiện
opportunity	dịp_tốt
horrifying	chăm_sóc
help	giúp_đỡ
fridge	tủ_lạnh
restos	nghỉ_ngơi
sunland	vùng_đất_mặt_trời
rough	thô
soldier	lính
cooker	nồi_cơm_điện
snuck	lẻn
chiselling	đục_đẽo
graduation	tốt_nghiệp
steambath	tắm_hơi
memority	thâm_niên
work	công_việc
hallo	ê
connected	kết_nối
more	hơn
wild	hoang_dã
beautifull	đẹp
mustgo	phải_đi
windbell	chuông_gió
khao	khao_khát
faces	những_khuôn_mặt
badger	lửng
member	thành_viên
restaurants	nhà_hàng
plowman	thợ_cày
penny	đồng_xu
mopds	cây_lau_nhà
moonlight	ánh_trăng
fascility	cơ_sở
tricks	thủ_thuật
crappy	thèm_thuồng
chillin	làm_lạnh
satissfied	hài_lòng
willve	cây_liễu
ketchup	sốt_cà_chua
lent	cho_mượn
honeymoontrip	chuyến_đi_tuần_trăng_mật
selfies	ảnh_tự_chụp
december	tháng_mười_hai
port	hải_cảng
eveyday	hằng_ngày
portly	đẹp_đẽ
soup	súp
bycicle	xe_đạp
facillites	cơ_sở_vật_chất
thers	của_họ
supernice	tuyệt_đẹp
don	đừng
supervior	người_giám_sát
tele	điện_báo
cue	gợi_ý
bidaboard	bảng_đấu_thầu
sencerity	sự_chân_thành
surly	đột_ngột
minutes	phút
desaster	sa_mạc
xoai	xoài
holyday	ngày_thánh
second	thứ_hai
open	mở
areas	khu_vực
band	ban_nhạc
swimingpool	hồ_bơi
lazy	lười_biếng
soso	tam_tạm
screeches	tiếng_rít
mixologist	người_pha_trộn
flip	lật
scarrings	vết_sẹo
packeges	gói_hàng
activities	hoạt_động
downside	nhược_điểm
somewhen	lúc_nào_đó
definatley	chắc_chắn
tshirt	áo_thun
fav	yêu_thích
cutlery	dao_kéo
recastion	tuyển_dụng
vani	biến_mất
abbey	tu_viện
avalible	có_sẵn
hongkong	hồng_kông
ceramics	gốm_sứ
truc	trúc
stints	tiền_lương
becareful	hãy_cẩn_thận
bsthroom	phòng_tắm
hour	giờ
riser	ống_đứng
gelish	hơi_sệt
drjnk	uống
those	những,_cái_đó
dog	chó
timh	thời_gian
shenanigans	tai_quái
traveled	đi_du_lịch
rest	nghỉ_ngơi
bun	bún
vietnm	việt_nam
todo	làm
last	cuối_cùng
cleen	làm_sạch
soakers	người_làm_bánh
appartments	căn_hộ
kingfishers	bói_cá
worderfull	lo_lắng
halo	hào_quang
win	thắng_lợi
banh	bánh
hidden	ẩn
served	phục_vụ
guinely	chân_thật
hochimin	hồ_chí_minh
dac	đắc
pusan	xô_đẩy
kinks	gấp_khúc
brew	ủ
tourists	khách_du_lịch
packers	người_đóng_gói
upgraded	nâng_cấp
golfview	đánh_gôn
ubran	thành_thị
guess	phỏng_đoán
rooster	gà_trống
bro	anh_bạn
receprptionist	lễ_tân
worldpress	báo_chí_thế_giới
adverftised	được_quảng_cáo
hioliday	ngày_lễ
touring	du_lịch
sympatyczni	giao_cảm
cigarets	thuốc_lá
mineral	khoáng_sản
images	hình_ảnh
oriental	phương_đông
church	nhà_thờ
handsome	đẹp
lolation	cách_ly
luxuy	sang_trọng
bedsheet	ga_trải_giường
fastfood	thức_ăn_nhanh
quiteness	sự_yên_tĩnh
frankly	thẳng_thắn
heath	cây_thạch_thảo
geckos	tắc_kè
ways	cách
fat	mập
notice	để_ý
facillity	cơ_sở
touristy	khách_du_lịch
loves	yêu
farm	nông_trại
regard	sự_quan_tâm
kayac	thuyền_kayac
voan	khăn_voan
flicking	nhấp_nháy
locals	người_dân_địa_phương
ganh	ganh_đua
redhouse	ngôi_nhà_màu_đỏ
streets	đường_phố
nightlife	cuộc_sống_về_đêm
found	tìm
towels	khăn_tắm
lager	bằng_lăng
mouse	chuột
defenetly	chắc_chắn
root	nguồn_gốc
cruises	du_lịch_trên_biển
beautifully	đẹp
amable	thân_thiện
attentiont	chú_ý
toiletories	đồ_vệ_sinh_cá_nhân
vespers	kinh_chiều
glass	cốc_thủy_tinh
film	phim_ảnh
handmock	tay_cầm
mast	cột_buồm
outdoor	ngoài_trời
careful	cẩn_thận
welldone	nấu_kỹ
fifteen	mười_lăm
stayed	ở_lại
prior	ưu_tiên
recomentded	đề_nghị
annnoying	làm_phiền
colleagues	đồng_nghiệp
colleague	đồng_nghiệp
employees	nhân_viên
 balance	cân_bằng
balance	cân_bằng
project	dự_án
task	nhiệm_vụ
policy	chính_sách
product	sản_phẩm
technical	kỹ_thuật
dev	lập_trình_viên
salary	lương
improve	cải_thiện
benefit	phúc_lợi
ability	khả_năng
flexible	linh__oạt
opened	cởi_mở
opend_mind	cởi_mở
internship	thực_tập
learn	học_hỏi
fresher	nhân_viên_chưa_có_kinh_nghiệm
supportive	hỗ_trợ
traning	đào_tạo
Working	làm_việc
overtime	làm_thêm_giờ
environment	môi_trường
match	phù_hợp
melody	giai_điệu
deal	thoả_thuận
Ko	không
Ko cao	không_cao
benefit	phúc_lợi
IT service	dịch_vụ_IT
OT	làm_thêm_giờ
ot	làm_thêm_giờ
Internship	thực_tập
env	môi_trường_làm_việc
Need to	
forcus	tập_trung
fresher	nhân_viên_mới
learn	học_tập
qualified employee	nhân_viên_giỏi
request	yêu_cấu
learning	học_tập
improve	cải_thiện
ability	khả_năng_của_họ
open-minded people	nhân_viên_cởi_mở
opened	cởi_mở
flexible working time	thời_gian_làm_việc_linh_hoạt
flexible	linh_hoạt
depend on	tuỳ_thuộc
teams	đội_nhóm
squads	đội_nhóm
provide	cung_cấp
conpensation	bồi_hoàn
supportive	hỗ_trợ
working environment	môi_trường_làm_việc
laptop	máy_tính_xách_tay
team	đội_nhóm
lap	máy_tính_xách_tay
cafe	cà_phê
Laptop	máy_tính_xách_tay
Cloud	đám_mây
young	trẻ
work	làm_việc
force	lực_lượng
Great	tuyệt_vời
music	âm_nhạc
gym	phòng_tập_thể_dục
relax	thư_giãn
Baby	em_bé
foot	chân
ping pong	ping_pong
table	bàn
Allowances	trợ_cấp
lunch	bữa_trưa
Travel	du_lịch
opportunities	cơ_hội
Team	đội
activities	hoạt_động
CSR	trách_nhiệm_xã_hội
buildings	tòa_nhà
company	công_ty
trips	chuyến_đi
Full	đầy_đủ
social	xã_hội
insurance	bảo_hiểm
unemployment	thất_nghiệp
health	sức_khỏe
Personal	cá_nhân
incident	sự_cố
Dynamic	năng_động
Cty	công_ty
wfh	làm_việc_từ_xa
opportunities	cơ_hội
Team	đội
activities	hoạt_động
CSR	trách_nhiệm_xã_hội
buildings	tòa_nhà
company	công_ty
trips	chuyến_đi
Full	đầy_đủ
social	xã_hội
insurance	bảo_hiểm
unemployment	thất_nghiệp
health	sức_khỏe
Personal	cá_nhân
incident	sự_cố
Dynamic	năng_động
TA	tiếng_anh
nv	nhân_viên
task	nhiệm_vụ
wfh	làm_việc_từ_xa
cty	công_ty
Company	công_ty
ai	ai
build	xây_dựng
cert	chứng_chỉ
dong nghiep vuive	đồng_nghiệp_vui_vẻ
sep	nhà_quản_lý
than thien	thân_thiện
cong viec	công_việc
co nhieu cai de hoc hoi	nhiều_cơ_hội_học_hỏi
good	tốt
space	không_gian_làm_việc
workspace	không_gian_làm_việc
space	không_gian
work from home	làm_việc_từ_xa
policy	chính_sách
Good	tốt
profile	hồ_sơ
pantry	kho_thực_phẩm
kitchen	bếp
gaming	game
remote	từ_xa
job	công_việc
need	cần
ask	hỏi
approval	phê_duyệt
Depend	phụ_thuộc
chances	cơ_hội
go	đi
HK	Hồng_Kông
JP	Nhật_Bản
EU	Châu_Âu
business trip	công_tác
culture	văn_hoá
French	tiếng_pháp
English	tiếng_anh
Chinese	người_trung_quốc
van phong	văn_phòng
thoang mat	thoáng_mát
nice view	cảnh_quan_đẹp
not	không
easy	dễ_dàng
software	phần_mềm
Vietnam	Việt_Nam
train	đào_tạo
student	sinh_viên
become	trở_thành
international	quốc_tế
engineer	kỹ_sư
career	sự_nghiệp
path	con_đường
fast	nhanh
slowly	chậm_rãi
calm	bình_tĩnh
years	năm
focus	tập_trung
Others	khác
maybe	có_thể
make	làm
junior	trẻ
hate	ghét
love	yêu
making	tạo_ra
trained	được_đào_tạo
doing well	làm_tốt
hope	hy_vọng
Singapore	Singapore
Hungary	Hungary
Switzerland	Thụy_Sĩ
students	sinh_viên
juniors	sinh_viên_năm_thứ_hai
chance	cơ_hội
stable	ổn_định
adapt	thích_nghi
confident	tự_tin
industry	ngành
paid	được_trả
more	nhiều
salary	lương
lucky	may_mắn
right	đúng
reason	lý_do
choosing	chọn
care	quan_tâm
about	về
because	vì
will	sẽ
pay	trả
low	thấp
with	với
competence	năng_lực
come	đến
after	sau
be	là
Flexible	linh_hoạt
should	nên
online	trực_tuyến
place	địa_điểm
such	như
interesting	thú_vị
projects	dự_án
carrer	sự_nghiệp
Not	không
many	nhiều
except	ngoại_trừ
critical	quan_trọng
situation	tình_huống
extra	thêm
training	đào_tạo
technical	kỹ_thuật
feedback	phản_hồi
mini	nhỏ
active	năng_động
log	ghi_chép
hour	giờ
mentor	người_hướng_dẫn
support	hỗ_trợ
tech	công_nghệ
best	tốt_nhất
development	phát_triển
review	đánh_giá
leader	lãnh_đạo
Customer	Khách_hàng
Service	Dịch_vụ
data	dữ_liệu
SQL	SQL
sale	bán_hàng
target	mục_tiêu
Google	Google
full	đầy_đủ
excel	excel
WFH	làm_việc_từ_xa
PM	nhân_viên_quản_lý_dự_án
Leader	trưởng_nhóm
tolet	nhà_vệ_sinh
BHXH	bảo_hiểm_xã_hội
BHYT	bảo_hiểm_y_tế
leng keng	leng_keng
senior	cao_cấp
View	xem
approve	phê_duyệt
free	miễn_phí
join	tham_gia
OFFICE	văn_phòng
file	tệp
take	lấy
control	kiểm_soát
Junior	trẻ
Manager	quản_lý
rank	cấp_bậc
admin	quản_trị
Bonus	thưởng
training	đào_tạo
HN	Hà_Nội
HCM	Hồ_Chí_Minh
Location	vị_trí
form	mẫu
performance	hiệu_suất
reviews	đánh_giá
twice	hai_lần
year	năm
ways	cách
contribute	đóng_góp
opportunity	cơ_hội
move	di_chuyển
higher	cao_hơn
professional	chuyên_nghiệp
engineers	kỹ_sư
provides	cung_cấp
new	mới
great	tuyệt_vời
things	thứ
hours	giờ
office	văn_phòng
once	một_lần
week	tuần
two	hai
even	thậm_chí
month	tháng
People	mọi_người
staffs	nhân_viên
CEO	giám_đốc_điều_hành
CTO	giám_đốc_công_nghệ
day	ngày
overtime	làm_thêm_giờ
offers	cung_cấp
excellent	xuất_sắc
facilities	cơ_sở_vật_chất
majority	đa_số
employees	nhân_viên
demonstrate	chứng_minh
strong	mạnh
ownership	quyền_sở_hữu
creating	tạo_ra
harmonious	hài_hòa
productive	năng_suất
flexibility	linh_hoạt
model	mô_hình
significant	đáng_kể
advantage	lợi_thế
does	có
require	yêu_cầu
charge	phí
managing	quản_lý
tasks	nhiệm_vụ
respects	tôn_trọng
Flutter	Flutter
Golang	Golang
deadline	hạn_chót
MAC	MAC
monitor	màn_hình
inch	inch
Remote	làm_việc_từ_xa
Office	văn_phòng
football	bóng_đá
HR	nhân_sự
Labour	lao_động
Contract	hợp_đồng
Benefit	phúc_lợi
Japan	Nhật_Bản
dinner	bữa_tối
intern	thực_tập
building	tòa_nhà
estimation	ước_lượng
event	sự_kiện
trainer	huấn_luyện_viên
sharing	chia_sẻ
manager	quản_lý
onboarding	nhận_việc
yoga	yoga
board	bảng
bonding	gắn_kết
stress	căng_thẳng
certificate	chứng_chỉ
planning	lập_kế_hoạch
thgian	thời_gian
Fresher	nhân_viên_mới
hr	phòng_nhân_sự
memtor	người_hướng_dẫn
làm việc onsite	làm_việc_onsite
customer	khách_hàng
auto	tự_động
Task	nhiệm_vụ
Ot	làm_thêm_giờ
tra luong	trả_lương
Gio_giac_thoai_mai	giờ_giấc_thoải_mái
Sep	nhà_quản_lý
Luong thuong	lương_thưởng
help each other	giúp_đỡ_lẫn_nhau
release	phát_hành
project	dự_án
developer	lập_trình_viên
approved	được_phê_duyệt
Onsite	tại_chỗ
collect	thu_thập
challenge	thử_thách
Covid	Covid
Party	tiệc
account	tài_khoản
referral	giới_thiệu
apply	nộp_đơn
Jira	Jira
Snack	đồ_snack
Teambuilding Trip	team_building
sign	ký
delay	trì_hoãn
Estimate	ước_lượng
colleagues	đồng_nghiệp
motivated	thúc_đẩy
solve problem	giải_quyết_vấn_đề
quickly	nhanh_chống
responsibly	có_tinh_thần_trách_nhiệm
DColleagues	đồng_nghiệp
friendly	thân_thiện
everything	mọi_thứ
colleague	đồng_nghiệp
mn	đồng_nghiệp
kn	kinh_nghiệm
high quality	chất_lượng_cao
willing listen	sẵn_sàng_lắng_nghe
devCompany	công_ty_công_nghệ
Ko	không
khong	không
dev	nhân_viên_lập_trình
agile	Agile
VN	Việt_Nam
Overtime	làm_thêm_giờ
fault	lỗi
Rarely	hiếm_khi
happen	xảy_ra
follow	theo_dõi
legal	hợp_pháp
convert	chuyển_đổi
money	tiền
allowance	trợ_cấp
offline	ngoại_tline
happy	hạnh_phúc
hour	giờ
buffet	tiệc_buffet
meeting	cuộc_họp
freshers	nhân_viên_mới
fully	đầy_đủ
Product	sản_phẩm
taxi	taxi
freestyle	tự_do
experience	kinh_nghiệm
benefit	phúc_lợi
requires	yêu_cầu
mode	chế_độ
reason	lý_do
mqh	mối_quan_hệ
Environment	môi_trường_làm_việc
colleages	đổng_nghiệp
unpaid	không_trả_lương
clear	rõ_ràng
night	đêm
keeping	giữ
track	theo_dõi
effort	nỗ_lực
essential	thiết_yếu
benefits	phúc_lợi
swapped	đổi_chỗ
feel	cảm_thấy
moving	di_chuyển
towards	hướng_tới
returning	trở_lại
lot	nhiều
usually	thường_xuyên
due	do
being	tồn_tại
able	có_thể
meet	gặp
rule	quy_tắc
Supportive	hỗ_trợ
one	một
felt	cảm_thấy
welcomed	được_chào_đón
supported	được_hỗ_trợ
management	quản_lý
collaborative	hợp_tác
atmosphere	bầu_không_khi
encourages	khuyến_khích
idea	ý_tưởng
teamwork	làm_việc_đội
Growth	phát_triển
kha cu	cũ
Opportunities	cơ_hội
emphasis	nhấn_mạnh
through	thông_qua
programs	chương_trình
workshops	hội_thảo
greatly	rất_nhiều
contributed	đóng_góp
growth	phát_triển
keeps	giữ
Innovative	đổi_mới
Being	Là
part	phần
forward	tiến_về
thinking	tư_duy
embraces	chấp_nhận
technologies	công_nghệ
methodologies	phương_pháp
exciting	thú_vị
intellectually	trí_thức
stimulating	kích_thích
structured	có_cấu_trúc
ensuring	đảm_bảo
worked	đã_làm_việc
anual leave	nghỉ_phép_năm
Lots	nhiều
Opportunities	cơ_hội
emphasis	nhấn_mạnh
through	thông_qua
programs	chương_trình
workshops	hội_thảo
greatly	rất_nhiều
contributed	đóng_góp
growth	phát_triển
keeps	giữ
Innovative	đổi_mới
Being	Là
part	phần
forward	tiến_về
thinking	tư_duy
embraces	chấp_nhận
technologies	công_nghệ
methodologies	phương_pháp
exciting	thú_vị
intellectually	trí_thức
stimulating	kích_thích
structured	có_cấu_trúc
ensuring	đảm_bảo
worked	đã_làm_việc
rong rai	rộng_rãi
pm	quản_lý_dự_án
VNBenifit	phúc_lợi
participate	tham_gia
obligatory	bắt_buộc
However	Tuy_nhiên
decide	quyết_định
Cafe	quán_café
healthy	lành_mạnh
source	nguồn
voucher	phiếu_quà_tặng
Policy	chính_sách
computer	máy_tính
over	trên
months	tháng
covid	Covid
Hire	tuyển_dụng
despite	mặc_dù
AUTOSAR	AUTOSAR
global	toàn_cầu
estimate	ước_lượng
Time	thời_gian
Process	quy_trình
process	quy_trình
domain	lĩnh_vực
approve	phê_duyệt
Automotive	ô_tô
club	câu_lạc_bộ
aerobic	aerobic
badminton	cầu_lông
topic	chủ_đề
timing	thời_gian
located	nằm
issue	vấn_đề
worry	lo_lắng
Colleagues	đồng_nghiệp
express	bày_tỏ
thoughts	suy_nghĩ
levels	cấp_độ
managers	quản_lý
Every	mỗi
departments	bộ_phận
QA	nhân_viên_kiểm_tra_chất_lượng
Results	Kết_quả
slogan	khẩu_hiệu
CV	CV
Matter	Vấn_đề
Result	Kết_quả
Count	Đếm
signature	chữ_ký
promote	thăng_chức
Beautiful	Đẹp
Slogan	khẩu_hiệu
Max	Tối_đa
internal	nội_bộ
tick	đánh_dấu
design	thiết_kế
confirm	xác_nhận
load	tải
comfortable	thoải_mái
enjoyable	thú_vị
everyone	mọi_người
treat	đối_xử
family	gia_đình
fun	vui
everyday	hàng_ngày
Boss	sếp
learned	học_hỏi
Free	miễn_phí
end	kết_thúc
bond	gắn_kết
welcome	chào_mừng
Training	đào_tạo
overview	tổng_quan
Project	dự_án
engineering	kỹ_thuật
Teambuilding	xây_dựng_đội_ngũ
Improve	cải_thiện
payroll	bảng_lương
Skype	Skype
Reputation	danh_tiếng
value	giá_trị
open	mở
trust	tin_tưởng
result	kết_quả
oriented	định_hướng
Hardware	phần_cứng
Software	phần_mềm
Strong	mạnh_mẽ
Excellent	xuất_sắc
knowledge	kiến_thức
improvement	cải_tiến
position	vị_trí
skillful	khéo_léo
employee	nhân_viên
infrastructure	cơ_sở_hạ_tầng
modern	hiện_đại
Diversity	đa_dạng
innovation	đổi_mới
travel	du_lịch
First	đầu_tiên
example	ví_dụ
Second	thứ_hai
Last	cuối_cùng
directly	trực_tiếp
customers	khách_hàng
Working	làm_việc
manage	quản_lý
Have	có
Teanbuilding	team_building
Chat chit	chat_chít
Mac	macbook
Macmini	macbook
iMac	macbook
mac	macbook
Max	Tối_đa
internal	nội_bộ
tick	đánh_dấu
design	thiết_kế
confirm	xác_nhận
load	tải
comfortable	thoải_mái
enjoyable	thú_vị
everyone	mọi_người
treat	đối_xử
family	gia_đình
fun	vui
everyday	hàng_ngày
Boss	sếp
learned	học_hỏi
Free	miễn_phí
end	kết_thúc
bond	gắn_kết
welcome	chào_mừng
Training	đào_tạo
overview	tổng_quan
Project	dự_án
engineering	kỹ_thuật
Teambuilding	xây_dựng_đội_ngũ
Improve	cải_thiện
payroll	bảng_lương
Skype	Skype
Reputation	danh_tiếng
value	giá_trị
open	mở
trust	tin_tưởng
result	kết_quả
oriented	định_hướng
Hardware	phần_cứng
Software	phần_mềm
Strong	mạnh_mẽ
Excellent	xuất_sắc
knowledge	kiến_thức
improvement	cải_tiến
position	vị_trí
skillful	khéo_léo
employee	nhân_viên
infrastructure	cơ_sở_hạ_tầng
modern	hiện_đại
Diversity	đa_dạng
innovation	đổi_mới
travel	du_lịch
First	đầu_tiên
example	ví_dụ
Second	thứ_hai
Last	cuối_cùng
directly	trực_tiếp
customers	khách_hàng
Working	làm_việc
manage	quản_lý
Have	có
knowing	biết
long	dài
term	kỳ_hạn
short	ngắn
term	kỳ_hạn
all	tất_cả
world	thế_giới
refresh	làm_mới
Voucher	phiếu_quà_tặng
internship	thực_tập
serectary	thư_ký
eveythings	mọi_thứ
SV	sinh_viên
trainning	đào_tạo
rotation	luân_phiên
map road	lộ_trình
canteen	căn_tin
newbie	nhân_viên_mới
internatinal	quốc_tế
Nice	dễ_mến
families	gia_đình
win	hệ_điều_hành_window
motivate	tận_tuỵ
desktop	máy_tính_để_bàn
course	khoá
document	tài_liệu
automative	tự_động
rotate	luân_phiên
Max	Tối_đa
internal	nội_bộ
tick	đánh_dấu
design	thiết_kế
confirm	xác_nhận
load	tải
comfortable	thoải_mái
enjoyable	thú_vị
everyone	mọi_người
treat	đối_xử
family	gia_đình
fun	vui
everyday	hàng_ngày
Boss	sếp
learned	học_hỏi
Free	miễn_phí
end	kết_thúc
bond	gắn_kết
welcome	chào_mừng
Training	đào_tạo
overview	tổng_quan
Project	dự_án
engineering	kỹ_thuật
Teambuilding	xây_dựng_đội_ngũ
Improve	cải_thiện
payroll	bảng_lương
Skype	Skype
Reputation	danh_tiếng
value	giá_trị
open	mở
trust	tin_tưởng
result	kết_quả
oriented	định_hướng
Hardware	phần_cứng
Software	phần_mềm
Strong	mạnh_mẽ
Excellent	xuất_sắc
knowledge	kiến_thức
improvement	cải_tiến
position	vị_trí
skillful	khéo_léo
employee	nhân_viên
infrastructure	cơ_sở_hạ_tầng
modern	hiện_đại
Diversity	đa_dạng
innovation	đổi_mới
travel	du_lịch
First	đầu_tiên
example	ví_dụ
Second	thứ_hai
class	lớp
Last	cuối_cùng
directly	trực_tiếp
customers	khách_hàng
Working	làm_việc
manage	quản_lý
password	mật_khẩu
beautiful	đẹp
heart	trái_tim
lie	nói_dối
ONSITE	làm_việc_onsite
Onsite	làm_việc_onsite
Outsourcing	công_ty_gia_công
On Site	làm_việc_onsite
tester	nhân_viên_kiểm_tra_phần_mềm
SalaryCapgemini	lương_Capgemini
performamce	hiệu_suất
France	Nước_Pháp
coder	lập_trình_viên
test	kiểm_tra
Ok	ổn
HAI PHONG	hải_phòng
change	thay_đổi
big	lớn
community	cộng_đồng
designer	nhà_thiết_kế
Lunch	bữa_trưa
moment	khoảnh_khắc
Relaxed	thư_giãn
welcoming	chào_mừng
fulfilling	thỏa_mãn
required	yêu_cầu
demanded	đòi_hỏi
survey	khảo_sát
private	riêng_tư
sponsor	nhà_tài_trợ
upgrade	nâng_cấp
bank	ngân_hàng
finance	tài_chính
submit	nộp
timesheet	bảng_thời_gian
signoff	ký_xác_nhận
Request	yêu_cầu
ethic	đạo_đức
Online	trực_tuyến
formal	chính_thức
Multinational	đa_quốc_gia
Competitive	cạnh_tranh
values	giá_trị
Honesty	trung_thực
Trust	tin_tưởng
Freedom	tự_do
Spirit	tinh_thần
Modesty	khiêm_tốn
Fun	vui_vẻ
Collaborative	hợp_tác
Business	kinh_doanh
Experience	kinh_nghiệm
unique	độc_đáo
way	cách
clients	khách_hàng
achieve	đạt_được
Better	tốt_hơn
Faster	nhanh_hơn
More	nhiều_hơn
Sustainable	bền_vững
delivery	giao_hàng
having	có
Right	đúng
Resource	tài_nguyên
Place	nơi
PEOPLE	con_người
matter	quan_trọng
results	kết_quả
count	tính_toán
huge	khổng_lồ
system	hệ_thống
adventure	cuộc_phiêu_lưu
handle	phụ_trách
Polan	ba_lan
room	phòng
Lan	mạng_Lan
REMOTE	làm_việc_remote
có thể làm việc hybrid	có_thể_làm_việc_từ_xa
Hybrid	làm_việc_từ_xa
public	công_cộng
Engineer	Kỹ_sư
decent	tốt
options	tùy_chọn
location	địa_điểm
Stress	căng_thẳng
Lead	dẫn_dắt
pass	vượt_qua
talk	nói_chuyện
host	chủ_trì
budget	ngân_sách
sharp	sắc_bén
emotionally	cảm_xúc
intelligent	thông_minh
collaboration	hợp_tác
running	hoạt_động
smoothly	trôi_chảy
Founders	người_sáng_lập
changes	thay_đổi
transparent	minh_bạch
flat	phẳng
share	chia_sẻ
ideas	ý_tưởng
deliver	giao_hàng
chill	thư_giãn
double	gấp_đôi
awesome	tuyệt_vời
would	sẽ
definitely	chắc_chắn
leadership	lãnh_đạo
cool	tuyệt
grow	phát_triển
professionally	chuyên_nghiệp
personally	cá_nhân
In	Trong
specific	cụ_thể
Professional	chuyên_nghiệp
procedures	quy_trình
International	quốc_tế
standards	tiêu_chuẩn
Landmark	toà_nhà_Landmark
halloween	lễ_Halloween
pc	máy_tính_để_bàn
holiday	nghỉ_lễ
gathering	thu_thập
renew	làm_mới
Engineering	kỹ_sư
documentation	tài_liệu
okay	ổn
Resort	khu_nghỉ_dưỡng
recommended	khuyến_nghị
proactively	chủ_động
blaming	đổ_thừa
latest	mới_nhất
spec	thông_số
configuration	cấu_hình
whole	toàn_bộ
destination	điểm_đến
remotely	từ_xa
setting	cài_đặt
attractive	hấp_dẫn
Employment	việc_làm
completely	hoàn_toàn
totally	hoàn_toàn
possibilities	khả_năng
configurable	có_thể_cấu_hình
enjoy	tận_hưởng
surroundings	môi_trường_xung_quanh
including	bao_gồm
delectable	ngon_lành
pays	trả
respectable	đáng_kính
wage	tiền_lương
settings	cài_đặt
language	ngôn_ngữ
instruction	hướng_dẫn
purchases	mua_sắm
impressive	ấn_tượng
parts	phần
extremely	cực_kỳ
collaborate	hợp_tác
finest	tốt_nhất
Additionally	thêm_vao
compelling	hấp_dẫn
goal	mục_tiêu
distinguishes	phân_biệt
frequent	thường_xuyên
disclosure	công_bố
transparency	minh_bạch
purpose	mục_đích
aims	mục_tiêu
unusual	không_bình_thường
sector	lĩnh_vực
notable	đáng_chú_ý
element	yếu_tố
equitable	công_bằng
approach	cách_tiếp_cận
common	phổ_biến
backend	backend
frontend	frontend
OKR	OKR
metric	chỉ_số
promotion	khuyến_mãi
mandatory	bắt_buộc
receive	nhận
Yearly	hàng_năm
distinct	riêng_biệt
budgets	ngân_sách
equipment	thiết_bị
Generous	hào_phóng
Year	năm
encouraging	khuyến_khích
improving	cải_thiện
catching	bắt_kịp
trend	xu_hướng
discuss	thảo_luận
Vision	Tầm_nhin
communicates	giao_tiếp
seen	nhìn_thấy
understand	hiểu
matters	quan_trọng
Gatherings	buổi_tụ_họp
blast	bùng_nổ
invested	đầu_tư
know	biết
workers	người_lao_động
around	xung_quanh
Even	thậm_chí
joined	tham_gia
couple	cặp
invited	mời
Compensation	bồi_thường
tier	cấp
country	quốc_gia
entry	nhập_cảnh
positions	vị_trí
think	nghĩ
saved	tiết_kiệm
spent	chi_tiêu
traffic	giao_thông
jams	tắc_nghẽn
rent	tiền_thuê
output	đầu_ra
micromanage	quản_lý_chi_tiết
monthly	hàng_tháng
vacations	kỳ_nghỉ
plays	chơi
success	thành_công
opinions	ý_kiến
voice	tiếng_nói
heard	nghe
guidance	hướng_dẫn
listened	lắng_nghe
Catchup	bắt_kịp
center	trung_tâm
shoutout	lời_khen
Feed	thông_tin
refund	hoàn_tiền
leisure	giải_trí
Pros	ưu_điểm
Cons	nhược_điểm
surprised	ngạc_nhiên
amazing	tuyệt_vời
embracing	ôm_lấy
respectful	tôn_kính
facilitate	tạo_điều_kiện
impactful	có_tác_động
holds	giữ
impeccable	hoàn_hảo
celebrating	kỷ_niệm
prepared	chuẩn_bị
pretty	đẹp
solid	vững_chắc
user	người_dùng
maximum	tối_đa
grab	nắm_bắt
Social	xã_hội
anniversary	kỷ_niệm
marathon	marathon
region	khu_vực
Forever	mãi_mãi
status	trạng_thái
regardless	bất_kể
principle	nguyên_tắc
saving	tiết_kiệm
cost	chi_phí
commuting	đi_lại
Security	bảo_mật
device	thiết_bị
equipments	thiết_bị
joining	tham_gia
given	đã_cho
luxurious	sang_trọng
dining	ẩm_thực
types	loại
leaves	lá
sick	ốm
strictly	nghiêm_túc
follows	theo
labour	lao_động
laws	luật
urgent	khẩn_cấp
impact	tác_động
Budget	ngân_sách
experiences	kinh_nghiệm
lend	cho_vay
helping	giúp_đỡ
hand	tay
close	gần
range	mức
knit	đan
Meetings	cuộc_họp
discussions	thảo_luận
valuable	giá_trị
outcomes	kết_quả
With	với
arrangements	sắp_xếp
find	tìm
bonuses	tiền_thưởng
incentives	khuyến_khích
supports	hỗ_trợ
progresses	tiến_triển
built	xây_dựng
improvements	cải_cách
Regular	thường_xuyên
market	thị_trường
foreigners	người_nước_ngoài
virtually	gần_như
finish	hoàn_tất
avoid	tránh
disturbing	làm_rối
evidence	bằng_chứng
layoff	sa_thải
metrics	chỉ_số
As	như
prefer	thích
based	dựa_trên
health	sức_khỏe
coverage	bảo_hiểm
spouse	bạn_đời
children	trẻ_em
insights	hiểu_biết
Monday	Thứ_2
Friday	Thứ_6
real	thực
title	tiêu_đề
oncall	trực
Funding	tài_trợ
issued	phát_hành
expenses	chi_phí
convenient	tiện_lợi
responsible	có_trách_nhiệm
thoughtfully	suy_nghĩ
scaling	mở_rộng
feels	cảm_thấy
overwhelming	áp_lực
divide	chia
scope	phạm_vi
deadline	hạn_chót
robust	mạnh_mẽ
facilitating	tạo_điều_kiện
held	tổ_chức
star	ngôi_sao
exceptional	xuất_sắc
stunning	ngoạn_mục
destinations	điểm_đến
anything	bất_cứ_thứ_gì
access	truy_cập
mentorships	sự_hướng_dẫn
schedules	lịch_trình
mandated	được_quy_định
async	bất_đồng_bộ
culture	văn_hóa
far	xa
Offers	đề_nghị
salaries	mức_lương
Provides	cung_cấp
conducts	tiến_hành
weekly	hàng_tuần
Cares	quan_tâm
About	về
Demonstrates	chứng_minh
genuine	chân_thật
evidenced	bằng_chứng
hospital	bệnh_viện
stay	ở_lại
VIP	VIP
poisoning	ngộ_độc
received	nhận
costs	chi_phí
fruits	trái_cây
items	mặt_hàng
Enjoyment	sự_thoải_mái
Fosters	nuôi_dưỡng
organizes	tổ_chức
gatherings	buổi_tụ_họp
last	cuối
costs	chi_phí
fruits	trái_cây
items	khoản_mục
Grammarly	đúng_ngữ_pháp
Biz	kinh_doanh
fresher	nhân_viên_mới
BU	bộ_phận_BU
worldwide	rộng_khắp_thế_giới
traveled	du_lịch
Danang	đà_nẵng
encouraged	khuyến_khích
works	làm_việc
planned	lập_kế_hoạch
capacity	sức_chứa
vacations	kỳ_nghỉ
plays	trò_chơi
success	thành_công
voice	tiếng_nói
heard	trái_tim
guidance	hướng_dấn
own	nợ
listened	lắng_nghe
devs	lập_trình_viên
Catchup	bắt_kịp
center	trung_tâm
shoutout	nói_ra
recognise	nhận_ra
Feed	thức_ăn
refund	hoàn_trả
superb	tuyệt_vời
District	huyện
City	thành_phố
TP	thành_phố
friend	bạn
newest	mới_nhất
yourself	bản_thân
into	vào
Say	nói
named	được_gọi
troll	chọc_ghẹo
generali	tổng_quát
fund	quỹ
list	danh_sách
lots	nhiều
point	điểm
main	chính
Freely	tự_do
strategies	chiến_lược
Talent	tài_năng
believe	tin_tưởng
expectations	kỳ_vọng
let	cho_phép
Dollar	đô_la
interview	phỏng_vấn
strict	nghiêm_ngặt
saves	tiết_kiệm
traveling	du_lịch
healthcare	chăm_sóc_sức_khoẻ
Book	sách
Course	khóa_học
funds	quỹ
moves	di_chuyển
grows	phát_triển
voluntarily	tự_nguyện
quay	bến
lessons	bài_học
bon	tốt
chen	chen
Payroll	bảng_lương
progress	tiến_bộ
practical	thực_tế
interviewer	người_phỏng_vấn
too	cũng
miss	nhớ
Most	nhất
visit	thăm
Wohoooo	hoan_hô
Shout	hét
recognize	nhận_ra
show	cho_thấy
gratitude	lòng_biết_ơn
rush	vội_vàng
honest	trung_thực
foosball	bóng_bàn
fireball	quả_cầu_lửa
Backoffice	văn_phòng_phụ_trợ
timework	làm_việc_theo_thời_gian
HRM	quản_lý_nhân_sự
maintain	duy_trì
khoang	không
MVP	cầu_thủ_xuất_sắc_nhất
Aws	AWS
strategic	chiến_lược
attire	trang_phục
between	giữa
Start	bắt_đầu
experiment	thí_nghiệm
mistakes	sai_lầm
mandate	nhiệm_vụ
related	liên_quan
fintech	công_nghệ_tài_chính
corporate	doanh_nghiệp
human	con_người
abilities	khả_năng
became	trở_th
rotation	luân_phiên
max	tối_đa
Very	rất
Mua BH	mua_bảo_hiểm
OTVery	làm_thêm_giờ_nhiều
zone	khu_vực
bus	xe_đưa_đón
portal	trang_portal
laptopLinh	máy_tính_xách_tay
highlands	cà_phê_highlands
tracking	theo_dõi
TV	tivi
VP	văn_phòng
starbuck	cà_phê_starbuck
house	nhà
trending	xu_hướng
thinh hanh	thịnh_hành
cntt	công_nghệ_thông_tin
dicuss	thảo_luận
events	sự_kiện
concept	khái_niệm
soft	mềm
Big	lớn
choose	chọn
cf	cà_phê
want	muốn
Offer	đề_nghị
courses	khoá_học
conducted	chỉ_đạo
external	bên_ngoài
providers	nhà_cung_cấp
india	ấn_độ
japan	nhật_bản
pressure	áp_lực
worker	lực_lượng_lao_động
cv	hồ_sơ_xin_việc
challange	thử_thách
nuoc ngoai	nước_ngoài
Mechanic	máy_móc
NO	không
Healthcare	chăm_sóc_sức_khoẻ
insuranceThoai	bảo_hiểm
want	cần
Sing	singapore
Tgian	thời_gian
onl	trực_tuyến
zone	vùng
CBTW	cán_bộ_trung_ương
indo	indonesia
call	gọi
CALL	gọi
HCMC	thành_phố_hồ_chí_minh
Chocopie	bánh_chocopie
Hero	người_hùng
metric	đo_lường
promotion	thăng_tiến
mandatory	bắt_buộc
Year	năm
Center	trung_tâm
UK	nước_anh
AU	nước_Úc
NZ	nước_newzealand
Philippines	nước_philippines
folks	mọi_người
couple	đôi
Compensation	bồi_hoàn
micromanage	quản_lý_vi_mô
monthly	hàng_tháng
Saigon	sài_gòn
sports	thể_thao
groups	nhóm
Device	thiết_bị
Anytime	bất_kỳ_lúc_nào
assigned	được_phân_công
magicians	ảo_thuật_gia
squad	đội_nhóm
literally	theo_nghĩa_đen
perform	biểu_diễn
magic	phép_thuật
record	ghi_lại
accordingly	tương_ứng
packages	gói_hàng
buying	mua
others	những_người_khác
since	kể_từ_khi
starting	bắt_đầu
Luxury	xa_xỉ
leisure	giải_trí__
Pros	ưu_điểm__
Cons	nhược_điểm__
Disk	đĩa__
OTEH	oteh__
States	các_bang__
superior	vượt_trội__
super	siêu__
helpful	hữu_ích__
shows	chương_trình__
rest	nghỉ_ngơi__
products	sản_phẩm__
Overall	tổng_thể__
whether	liệu__
light	nhẹ__
heavy	nặng__
ones	những_người__
wants	mong_muốn__
Only	chỉ__
happened	đã_xảy_ra__
changing	thay_đổi__
opinion	ý_kiến__
Rails	đường_ray__
demo	bản_demo__
Head	cái_đầu__
Provide	cung_cấp__
logging	ghi_nhật_ký__
judge	đánh_giá__
freely	tự_do__
balancing	cân_bằng__
currently	hiện_tại__
drives	điều_khiển__
myself	bản_thân_tôi__
And	và__
eat	ăn
occasion	dịp
satisfy	làm_hài_lòng
mood	tâm_trạng
motivation	động_lực
PR	quan_hệ_công_chúng
refill	nạp_lại
Hi	xin_chào__
burn	đốt
Bugdet	ngân_sách
R	ngôn_ngữ_R
saves	tiết_kiệm
traveling	du_lịch
healthcare	chăm_sóc_sức_khoẻ
Book	sách
Course	khóa_học
funds	quỹ
moves	di_chuyển
grows	phát_triển
voluntarily	tự_nguyện
quay	bến
lessons	bài_học
bon	tốt
chen	chen
Payroll	bảng_lương
progress	tiến_bộ
practical	thực_tế
interviewer	người_phỏng_vấn
too	cũng
miss	nhớ
Most	nhất
visit	thăm
Wohoooo	hoan_hô
Shout	hét
recognize	nhận_ra
show	cho_thấy
gratitude	lòng_biết_ơn
rush	vội_vàng
honest	trung_thực
foosball	bóng_bàn
fireball	quả_cầu_lửa
Backoffice	văn_phòng_phụ_trợ
timework	làm_việc_theo_thời_gian
HRM	quản_lý_nhân_sự
maintain	duy_trì
khoang	không
MVP	cầu_thủ_xuất_sắc_nhất
Aws	AWS
strategic	chiến_lược
attire	trang_phục
between	giữa
Start	bắt_đầu
experiment	thí_nghiệm
mistakes	sai_lầm
mandate	nhiệm_vụ
related	liên_quan
fintech	công_nghệ_tài_chính
corporate	doanh_nghiệp
human	con_người
abilities	khả_năng
became	trở_thành
employed	được_tuyển_dụng
welfare	phúc_lợi
regime	chế_độ
Women	phụ_nữ
Children	trẻ_em
Holidays	ngày_lễ
accordance	phù_hợp
State	tiểu_bang
Doanh	doanh
timeline	dòng_thời_gian
TT	TT
Startup	khởi_nghiệp
CBNV	cán_bộ_nhân_viên
CIO	Giám_đốc_công_nghệ_thông_tin
chan	chân
Xin	xin
nge	nghe
dat	đất
Khong	không
Dang ke	đáng_kể
Thich hợp	thích_hợp
balanceBenefit	phúc_lợi_đầy_đủ
OTQuy	quỹ_OT
freelancer	người_làm_tự_do
kits	bộ_dụng_cụ
freetime	thời_gian_rảnh
raAnh	ra_Anh
Khoa	khoa
touchbar	thanh_cảm_ứng
Young	trẻ
Passion	đam_mê
fail	thất_bại
constantly	liên_tục
passion	đam_mê
souls	linh_hồn
united	thống_nhất
talents	tài_năng
Passions	đam_mê
Yes	vâng
TRUE	đúng
Engine	động_cơ
Themes	chủ_đề
Technology	công_nghệ
Beautifull	đẹp
Open	mở
Workshop	hội_thảo
Coffee	cà_phê
xay	xay
FCS	FCS
Malaysia	Malaysia
Wish	ước
Cedric	Cedric
Chin	cằm
oniste	oniste
thua	thua
tui	túi
bowling	bowling
SM	SM
Magento	Magento
Forix	Forix
emergency	khẩn_cấp
server	máy_chủ
order	đơn_hàng
ever	từng
experienced	có_kinh_nghiệm
coworkers	đồng_nghiệp
importantly	quan_trọng
Amazing	tuyệt_vời
absolutely	hoàn_toàn
devoted	tận_tâm
along	dọc_theo
side	bên
treated	đối_xử
kindness	lòng_tốt
general	chung
Pretty	xinh_đẹp
beverages	đồ_uống
seniors	người_cao_tuổi
paids	đã_trả
guaranteed	đảm_bảo
BULs	BULs
FHM	FHM
leap	bước_nhảy
America	Mỹ
Korea	Hàn_Quốc
beforehand	trước
across	khắp
units	đơn_vị
handsomely	hào_phóng
BUL	BUL
fall	ngã
little	nhỏ
Nothing	không_có_gì
hard	khó
FSoft	FSoft
KH	KH
FPT	FPT
Language	ngôn_ngữ
Japanese	tiếng_Nhật
qualified	đủ_điều_kiện
msc	thạc_sĩ
Extra	thêm
activity	hoạt_động
BURemote	làm_việc_từ_xa
b	b
Domain	miền
Freshers	sinh_viên_mới_tốt_nghiệp
OTTraining	đào_tạo_OT
Outsource	thuê_ngoài
IoT	IoT
compensatory	bù_đắp
corresponding	tương_ứng
workplace	nơi_làm_việc
XJob	công_việc
studying	học
coz	vì
F	F
ensured	đảm_bảo
dare	dám
tough	khó_khăn
responsibilities	trách_nhiệm
possibility	khả_năng
recorded	ghi_lại
surely	chắc_chắn
hoursQuy	quy_giờ
BU	bộ_phận_BU
xjob	công_việc_x
bhxh	bảo_hiểm_xã_hội
income	thu_nhập
fresherFPT	sinh_viên_mới_FPT
rewarding	đáng_giá
hotfix	sửa_lỗi_khẩn_cấp
okie	ổn
Moi	mới
Sinh	sinh
Vien	viên
joiners	người_tham_gia
Pre	trước
Analyst	nhà_phân_tích
structural	cấu_trúc
basic	cơ_bản
OTWhile	trong_khi_OT
stands	đứng
terms	điều_khoản
enjoyment	niềm_vui
structure	cấu_trúc
consistency	tính_nhất_quán
completed	hoàn_thành
allowed	cho_phép
align	cân_bằng
entirely	hoàn_toàn
routine	thói_quen
predictability	khả_năng_dự_đoán
beneficial	có_lợi
degree	bằng_cấp
several	một_số
thrives	phát_triển_mạnh
internships	thực_tập
attract	thu_hút
khoa	khoa
nga	ngã
challengeGood	thử_thách_tốt
equiments	thiết_bị__
ram	ram__
mentors	người_hướng_dẫn__
goals	mục_tiêu__
done	đã_làm__
khui	khui__
CTy	công_ty__
TO	đến__
Zealand	zealand__
significantly	một_cách_đáng_kể__
aided	hỗ_trợ__
exists	tồn_tại__
robust	mạnh_mẽ__
facilitating	tạo_điều_kiện__
held	tổ_chức__
star	ngôi_sao__
exceptional	xuất_sắc__
stunning	tuyệt_đẹp__
destinations	điểm_đến__
don	khoác_lên__
anything	bất_cứ_điều_gì__
complainI	tôi_phàn_nàn__
access	truy_cập__
mentorships	chương_trình_định_hướng__
seamlessly	một_cách_liền_mạch__
breathtaking	ngoạn_mục__
schedules	lịch_trình__
mandated	được_ủy_nhiệm__
async	bất_đồng_bộ__
cultutre	văn_hóa__
far	xa__
known	được_biết_đến__
OTI	oti__
ITViec	itviec__
rate	đánh_giá__
Offers	đề_nghị__
salaries	mức_lương__
Provides	cung_cấp__
conducts	tiến_hành
Cares	quan_tâm__
About	về__
Demonstrates	thể_hiện__
genuine	chân_thành__
evidenced	được_chứng_minh__
five	năm
transforming	biến_đổi
methods	phương_pháp
nen	nên
okr	ổn
academy	học_viện
acadêmia	học_viện
accelator	tăng_tốc
accept	chấp_nhận
accerlator	trình_tăng_tốc
accessories	phụ_kiện
according	theo_như
achievable	có_thể_đạt_được
action	hành_động
actions	hành_động
adapet	thích_nghi
adaptive	thích_nghi
add	thêm
add_on	tiện_ích_bổ_sung
adhoc	tạm_thời
advise	tư_vấn
advisory	tư_vấn
again	lại
agency	đại_lý
agree	đồng_ý
ahead	dẫn_đầu
air	không_khí
airpod	tai_nghe_AirPod
airpods	tai_nghe_AirPods
alaska	Alaska
alert	cảnh_báo
algo	thuật_toán
algorithm	thuật_toán
allocation	phân_bổ
amateur	nghiệp_dư
udemyaccount	tài_khoản_Udemy
ultra	cực_kỳ
ultra sharp	cực_kỳ_sắc_nét
under	bên_dưới
underestimate	đánh_giá_thấp
underestimated	bị_đánh_giá_thấp
understanding	sự_hiểu_biết
underwork	ít_việc
unexpected_problems	vấn_đề_bất_ngờ
unfair	không_công_bằng
unhappy	không_vui
unicorn	công_ty_unicorn
unit	đơn_vị
unlike	khác_với
unlimited	không_giới_hạn
unmaintainable	không_bảo_trì_được
unplan	không_có_kế_hoạch
until	cho_đến_khi
up	lên
update	cập_nhật
upload	tải_lên
upper	trên
upskill	nâng_cao_kỹ_năng
upskilling	quá_trình_nâng_cao_kỹ_năng
upto	đến
us	Mỹ
us_au	Mỹ_–_Úc
us_nhật	Mỹ_–_Nhật
us_sếp	quản_lý_người_Mỹ
us	Mỹ
used	đã_dùng
useful	hữu_ích
useless	vô_ích
users	người_dùng
using	đang_sử_dụng
utensils	dụng_cụ
utilize	tận_dụng
vacation	kỳ_nghỉ
vaccine	vắc_xin
vacxin	vắc_xin
valued	có_giá_trị
veloctiy	tốc_độ
vendor	nhà_cung_cấp
verify	xác_minh
version	phiên_bản
vertex	đỉnh
very	rất
very_nice	rất_tốt
vietnam	Việt_Nam
vietnamese	người_Việt_Nam
viettel_tower	toà_nhà_Viettel
woking	làm_việc
word	từ
workaround	cách_giải_quyết_tạm_thời
workation	làm_việc_kết_hợp_du_lịch
workations	làm_việc_trong_kỳ_nghỉ
workcation	làm_việc_trong_kỳ_nghỉ
workflow	quy_trình_làm_việc
working	làm_việc
working for	làm_việc_cho
working_here	làm_việc_ở_đây
working oversea	làm_việc_ở_nước_ngoài
working time	thời_gian_làm_việc
worklife balance	cân_bằng_giữa_công_việc_và_cuộc_sống
worklife	cuộc_sống_công_việc
workload	khối_lượng_công_việc
worklog	ghi_chép_công_việc
workshop	hội_thảo
workstation	khu_vực_làm_việc
workstyle	phong_cách_làm_việc
worrk	công_việc
first	đầu_tiên
pantry	phòng_ăn
wrap_up	tổng_kết
carrier	sự_nghiệp
certificated	chứng_chỉ
certificates	chứng_chỉ
certified	chứng_chỉ
certiticate	chứng_chỉ
certs	chứng_chỉ
cfer	chứng_chỉ
IT service dịch vụ IT	
abilities	khả_năng
ability	khả_năng
aboard	trên_tàu/thuyền/máy_bay
abroad	ở_nước_ngoài
absorb	hấp_thụ
abundant	dồi_dào
academy	học_viện
accelator	bộ_tăng_tốc
accenture	Accenture
accepted	được_chấp_nhận
accerlator	bộ_tăng_tốc
accessible	có_thể_tiếp_cận
accessories	phụ_kiện
accommodate	chứa,_đáp_ứng
accommodating	niềm_nở,_sẵn_sàng_giúp_đỡ
accomplishment	thành_tựu
accord	sự_đồng_thuận
accordance	theo_như
according	theo_như
accordingly	phù_hợp
account	tài_khoản
accountant	kế_toán
accounts	tài_khoản
accuracy	độ_chính_xác
accurate	chính_xác
accurately	chính_xác
achievable	có_thể_đạt_được
achieve	đạt_được
achievement	thành_tích
acknowledges	công_nhận
acquire	đạt_được
across	qua
act	hành_động
actions	hành_động
activates	kích_hoạt
active	năng_động
actively	tích_cực
activity	hoạt_động
actual	thực_tế
actuality	thực_trạng
adapt	thích_nghi
adaptability	khả_năng_thích_nghi
adaption	khả_năng_thích_nghi
adaptive	thích_ứng
added	đã_thêm
additionally	thêm_vào_đó
addressing	giải_quyết
adequate	đầy_đủ,_tương_xứng
adequately	một_cách_đầy_đủ
adhoc	tạm_thời,_không_chính_thức
adjust	điều_chỉnh
adjustable	có_thể_điều_chỉnh
adjustment	sự_điều_chỉnh
adjustments	các_sự_điều_chỉnh
admins	quản_trị_viên
admiration	sự_ngưỡng_mộ
admit	thừa_nhận
adopts	chấp_nhận,_áp_dụng
advanced	tiên_tiến
advancement	sự_tiến_bộ
advancements	các_tiến_bộ
advantage	lợi_thế
adventure	cuộc_phiêu_lưu
advertised	được_quảng_cáo
advice	lời_khuyên
advise	khuyên
advisory	tư_vấn
aem	phần_mềm_AEM
aerobic	aerobic,_thể_dục_nhịp_điệu
aerospace	hàng_không_vũ_trụ
affecting	ảnh_hưởng_đến
affects	ảnh_hưởng
affectting	ảnh_hưởng
afford	có_khả_năng_chi_trả
afk	vắng_mặt
afterward	sau_đó
agie	agile
agile	linh_hoạt,_mô_hình_Agile
agree	đồng_ý
agreed	đã_đồng_ý
ahead	phía_trước
aided	được_hỗ_trợ
aim	mục_tiêu
aiming	nhắm_tới
aims	các_mục_tiêu
airpod	tai_nghe_airpod
airpods	tai_nghe_airpods
alcoholic	có_cồn
alige	agile
align	căn_chỉnh
aligned	đã_căn_chỉnh
aligning	đang_căn_chỉnh
aligns	căn_chỉnh_(dạng_số_ít)
alleviate	giảm_bớt
allocate	phân_bổ
allocating	đang_phân_bổ
allocation	sự_phân_bổ
allowance	trợ_cấp
allowances	các_khoản_trợ_cấp
allowing	cho_phép
along	dọc_theo
alongs	dọc_theo
alongside	bên_cạnh
alternative	thay_thế
alway	luôn
ambiguos	không_chắc_chắn
ambiguous	không_chắc_chắn
america	nước_Mỹ
amin	nhân_viên_hành_chính
among	trong_số
ample	phong_phú,_dồi_dào
analysis	phân_tích
analyst	nhà_phân_tích
mỗi năm	hằng_năm
animal	động_vật
anniversaries	kỷ_niệm
announcement	thông_báo
annoyed	bực_bội
annually	hàng_năm
annualy	hằng_năm
answer	câu_trả_lời
anual	hằng_nắm
anybody	bất_kỳ_ai
anydesk	phần_mềm_anydesk
anymore	không_còn_nữa
anytime	bất_kỳ_lúc_nào
aon	bảo_hiểm_aon
apart	cách_xa,_tách_rời
appealing	hấp_dẫn
appears	xuất_hiện
appliance	thiết_bị
appliances	các_thiết_bị
application	ứng_dụng
applications	các_ứng_dụng
applied	đã_áp_dụng
applies	áp_dụng
apply	nộp_đơn
appprove	phê_duyệt
appreciates	đánh_giá_cao
approach	cách_tiếp_cận
approachability	tính_dễ_tiếp_cận
approachable	dễ_tiếp_cận
approaching	đang_đến_gần
appropriate	phù_hợp
appropriately	một_cách_phù_hợp
approval	sự_chấp_thuận
approve	chấp_thuận
approved	đã_chấp_thuận
approver	người_phê_duyệt
approves	chấp_thuận
arb	chênh_lệch_giá
arbitrary	tùy_ý
arch	vòm
architect	kiến_trúc_sư
architects	các_kiến_trúc_sư
architecture	kiến_trúc
archive	lưu_trữ
arguing	tranh_luận
arise	nảy_sinh
ark	tàu
arm	cánh_tay
arrange	sắp_xếp
arrangement	sự_sắp_xếp
arrangements	các_sự_sắp_xếp
arrogant	kiêu_ngạo
articles	điều_khoản
artist	nghệ_sĩ
aspect	khía_cạnh
aspects	các_khía_cạnh
aspirations	khát_vọng
assessment	đánh_giá
asset	tài_sản
assets	các_tài_sản
assigned	được_giao
assignment	nhiệm_vụ
assignments	các_nhiệm_vụ
assistance	sự_hỗ_trợ
associate	liên_kết
assurance	sự_đảm_bảo
async	bất_đồng_bộ
athenz	Athenz_(tên_hệ_thống_kiểm_soát_truy_cập_mã_nguồn_mở_của_Yahoo)
attempt	nỗ_lực
attend	tham_dự
attendance	sự_tham_dự_/_điểm_danh
attendees	người_tham_dự
attention	sự_chú_ý
attire	trang_phục
attitudes	thái_độ
attract	thu_hút
attracted	đã_bị_thu_hút
attractive	thu_hút,_hấp_dẫn
audit	kiểm_toán
australian	người_Úc_/_thuộc_về_nước_Úc
authority	quyền_lực_/_cơ_quan_có_thẩm_quyền
automation	tự_động_hóa
automative	(sai_chính_tả_–_có_thể_là_"automotive"_nghĩa_là_ô_tô)
automotive	thuộc_ngành_ô_tô
autonomy	tự_chủ
autosar	Autosar_(chuẩn_phần_mềm_ô_tô)
avoiding	tránh
aware	nhận_thức
aws	AWS_(dịch_vụ_điện_toán_đám_mây_của_Amazon)
axon	sợi_trục_(trong_tế_bào_thần_kinh)
azoom	Azoom_(có_thể_là_tên_công_ty_hoặc_nền_tảng)
backbone	xương_sống_/_trụ_cột_chính
backed	backend
backend	backend
backgr	backend
backgrounds	nền_tảng_/_bối_cảnh
backlog	công_việc_tồn_đọng
backoffice	bộ_phận_hỗ_trợ_nội_bộ
badminton	cầu_lông
baking	nướng
balance	cân_bằng
balanced	cân_đối
balancing	đang_cân_bằng
bands	nhóm_nhạc
banked	đã_gửi_ngân_hàng
banker	nhân_viên_ngân_hàng
banking	ngành_ngân_hàng
barem	thang_điểm
base	nền_tảng
based	dựa_trên
basis	nền_tảng
basketball	bóng_rổ
bata	Bata_(tên_thương_hiệu_giày_dép_quốc_tế)
bathrooms	phòng_tắm
battling	vật_lộn
bd	phát_triển_kinh_doanh
beans	đậu
becuz	bởi_vì
beenfit	phúc_lợi
beers	bia
beforehand	trước_đó
beginners	người_mới_bắt_đầu
behavior	hành_vi
beings	con_người
belief	niềm_tin
beliefs	niềm_tin
belong	thuộc_về
belonging	gắn_bó
bench	chuẩn_mực
benchmark	chuẩn_mực
beneficial	phúc_lợi
benefir	phúc_lợi
benefit	phúc_lợi
benefits	phúc_lợi
benifits	phúc_lợi
beraucracy	quan_Liêu
bereavement	sự_mất_mát
beverages	đồ_uống
bg	nền_tảng
bhsk	bảo_hiểm_sức_khoẻ
bhxh	bảo_hiểm_xã_hội
bhyt	bảo_hiểm_y_tế
bid	đấu_thầu
biface	hai_mặt
bigbliebutton	nền_tảng_học_trực_tuyến_bigbluebutton
bigcorp	tập_đoàn_lớn
bigdata	dữ_liệu_lớn
bigger	lớn_hơn
biggest	lớn_nhất
billiards	bi-a
billionaire	tỷ_phú
birds	con_chim
birthdays	sinh_nhật
biztrip	chuyến_công_tác
blabla	lảm_nhảm
blame	đổ_lỗi
blast	bùng_nổ
blocked	bị_chặn
blocker	yếu_tố_cản_trở
boasts	khoe_khoang
boc	ban_giám_đốc
bod	hội_đồng_quản_trị
bods	mọi_người
boh	hậu_cần
boldness	sự_táo_bạo
bonding	sự_gắn_bó
bonds	sự_gắn_bó
bonnus	tiền_thưởng
bonuses	tiền_thưởng
books	sách
bookworm	mọt_sách
boost	tăng_cường
boosting	tăng_cường
boot	khởi_động
bootcamp	khóa_học_cường_độ_cao
booth	gian_hàng
booths	các_gian_hàng
boshc	bosch
bosses	sếp
bossy	hách_dịch
both	cả_hai
bottled	đóng_chai
bottleneck	nút_thắt
bottlenecks	nút_thắt
bouldering	môn_thể_thao_leo_núi_đá_không_dây
bound	ràng_buộc
branding	xây_dựng_thương_hiệu
bread	bánh_mì
breaking	nghỉ_ngơi
breaks	giờ_nghỉ
breakthrough	đột_phá
bridgese	cầu_nối
bridging	kết_nối
bring	mang_đến
bringing	đang_mang_lại
broadcasted	đã_phát_sóng
broader	rộng_hơn
browser	trình_duyệt
brse	kỹ_sư_cầu_nối
bse	kỹ_sư_cầu_nối
budge	nhúc_nhích
budgeted	dự_trù_ngân_sách
budgets	ngân_sách
bugeted	dự_trù_ngân_sách
builder	người_xây_dựng
builders	người_xây_dựng
buildings	tòa_nhà
buildup	xây_dựng
builiding	sai_chính_tả_–_có_thể_là_"building"
bulding	toà_nhà
bulead	trưởng_nhóm_BU
cantee	căn_tin
canteen	căn_tin
canteens	căn_tin
cantin	căn_tin
capabilities	năng_lực
capability	năng_lực
capacity	năng_lực
capgemini	công_ty_capgemini
career	sự_nghiệp
careerpath	con_đường_sự_nghiệp
careers	các_sự_nghiệp
carefully	cẩn_thận
cares	quan_tâm
carpet	thảm
carreer	sự_nghiệp
carrer	sự_nghiệp
carrerpath	con_đường_sự_nghiệp
carried	đã_mang_/_đã_thực_hiện
carrier	nhà_vận_chuyển
carry	mang
cases	trường_hợp
casually	thoải_mái
catan	cờ_catan
catching	bắt_kịp
catchup	bắt_kịp
cater	phục_vụ_ăn_uống
catin	căn_tin
cause	gây_ra
cbl	học_tập_dựa_trên_năng_lực
cbql	cán_bộ_quản_lý
cctalk	ứng_dụng_cctalk
cds	đĩa_cd
celebrate	tổ_chức
celebrating	tổ_chức
celebration	lễ_kỹ_niệm
centered	tập_trung_vào
centralized	tập_trung_hóa
centric	lấy_làm_trung_tâm
ceos	giám_đốc_điều_hành
cert	chứng_chỉ
certain	chắc_chắn
burnout	kiệt_sức
buses	xe_buýt
candidate	ứng_viên
candidates	ứng_viên
certicicate	chứng_chỉ
certificate	chứng_chỉ
certificated	được_cấp_chứng_chỉ
certificates	chứng_chỉ
certification	chứng_chỉ
certifications	chứng_chỉ
certified	được_cấp_chứng_chỉ
certiticate	chứng_chỉ
certs	chứng_chỉ
chained	ràng_buộc
chair	ghế
chairs	ghế
challange	thử_thách
challeging	đầy_thử_thách
challenge	thử_thách
challenged	đầy_thử_thách
challenges	thử_thách
challenging	đầy_thử_thách
champion	nhà_vô_địch
chances	cơ_hội
changer	thay_đổi
channel	kênh
channels	các_kênh
chapter	chương
character	tính_cách
characteristics	tính_cách
characterized	đặc_trưng
characters	nhân_vật
charity	từ_thiện
chart	biểu_đồ
charts	biểu_đồ
chase	theo_đuổi
teen	tuổi_teen
chasing	theo_đuổi
checkpoint	trạm_kiểm_soát
checkups	khám_sức_khỏe
chem	hóa_học
chess	cờ_vua
chewinggum	kẹo_cao_su
children	trẻ_em
childrens	trẻ_em
chinese	tiếng_Trung_Quốc
chocopie	bánh_ChocoPie
choosing	lựa_chọn
cio	giám_đốc_thông_tin
cities	thành_phố
tmcp	thương_mại_cổ_phẩn
tncn	thu_nhập_cá_nhân
tax	thuế
taxes	thuế
swap	hoán_đổi
stack	ngăn_xếp_/_chồng
stacks	nhiều_ngăn_xếp_/_nhiều_chồng
stage	giai_đoạn_/_sân_khấu
stco	STCO_(viết_tắt_–_cần_ngữ_cảnh_rõ_hơn)
steep	dốc_/_cao_(về_mức_độ)
sts	STS_(viết_tắt_–_cần_ngữ_cảnh_rõ_hơn)
stuck	bị_kẹt_/_bị_mắc
study	học_tập_/_nghiên_cứu
styl	phong_cách_(viết_rút_gọn)
succeed	thành_công
succesful	thành_công_(chính_tả_sai_của_“successful”)
sucess	thành_công_(chính_tả_sai_của_“success”)
sudden	đột_ngột
sugary	ngọt_như_đường
surface	bề_mặt
teck	technical_stack
teckstack technical_stack	
stack	technical_stack
stacks	technical_stack
stage	giai_đoạn_/_sân_khấu
stco	STCO_(viết_tắt_–_cần_ngữ_cảnh_rõ_hơn)
steep	dốc_/_cao_(về_mức_độ)
stuck	bị_kẹt
study	học_tập
styl	phong_cách
succeed	thành_công
succesful	thành_công
sucess	thành_công
sudden	đột_ngột
sugary	ngọt_như_đường
surface	bề_mặt
ecspecially	đặc_biệt
sea	biển
violin	đàn_vĩ_cầm
flower	hoa
quiet	yên_tĩnh
vertigo	chóng_mặt
thankyou	cảm_ơn
grab	chộp_lấy_/_nắm_lấy
englisch	tiếng_anh
estuary	cửa_sông
known	được_biết_đến
winter	mùa_đông__
hotel	khách_sạn__
friendlyim	thân_thiện_
mail	thư__
canary	chim_hoàng_yến__
excellences	sự_xuất_sắc__
street	đường_phố__
smell	mùi
center	trung_tâm__
redecoration	trang_trí_lại
clouds	công_nghệ_đám_mây__
conditonal	có_điều_kiện
cactus	xương_rồng__
hoziron	chân_trời_
hummorous	hài_hước_
windy	nhiều_gió__
container	thùng_chứa
hotline	đường_dây_nóng__
link	liên_kết__
market	thị_trường__
bond	trái_phiếu
recieptionist	lễ_tân
flamingo	chim_hồng_hạc__
teansfer	chuyển
imperial	thuộc_về_hoàng_gia
complain	phàn_nàn__
impresion	ấn_tượng_
resraurants	nhà_hàng_
jacuzzi	bồn_tắm_sục__
resorted	đã_nghỉ_dưỡng_(hoặc_dùng_đến_cái_gì,_tùy_ngữ_cảnh)__
gorgeous	tuyệt_đẹp__
okay	ổn__
shopaholics	nghiện_mua_sắm__
nice	đẹp__
waitress	bồi_bàn_
sparklingly	lấp_lánh
smashburger	bánh_mì_smashburger
foodstreets	phố_ẩm_thực__
mercury	sao_thủy__
omelettes	trứng_ốp_lết_
views	lượt_xem
eight	số_tám__
hilltop	đỉnh_đồi__
amenable	dễ_tiếp_thu
debts	nợ
debug	gỡ_lỗi
decades	thập_kỷ
demo	thử_nghiệm
democracy	dân_chủ
dental	nha_khoa
deny	từ_chối
deploy	triển_khai
depneds	phụ_thuộc_vào
dept	phòng_ban
depth	chiều_sâu
development	sự_phát_triển
each	mỗi
earn	kiếm_được
earned	kiếm_được
employ	tuyển_dụng
face	đối_mặt
faced	đối_mặt
fear	sợ_hãi
fluency	trôi_chảy
focas	dự_báo
ear	tai
geek	đam_mê_công_nghệ
group	nhóm
glue	keo_dán
hcmct	thành_phố_hồ_chí_minh
hear	nghe
necessary	cần_thiết
neck	cổ
nesscessary	cần_thiết
uit	đại_học_công_nghệ_thông_tin
vietnamita	người_việt_nam
feedback	phản_hồi
keyboard	bàn_phím
unless	trừ_khi
curve	đường_cong
worms	sâu_máy_tính
cycle	chu_kỳ
evolve	tiến_hoá
female	nữ
harvest	thu_hoạch
macbook	macbook
macbookos	macbook
morale	tinh_thần
pace	nhịp_độ
paced	nhịp_độ_chậm
role	vai_trò
roles	vai_trò
schedule	lịch_trình
sleek	mượt_mà
solve	giải_quyết
solved	giải_quyết
tackle	giải_quyết
vuive	vui_vẻ
coach	người_hướng_dẫn
copy	sao_chép
corp	công_ty
cross	qua
crowded	đông_đúc
cultural	văn_hoá
commutes	đi_lại
comply	tuân_thủ
composed	điềm_tĩnh
compulsary	bắt_buộc
compulsory	bắt_buộc
consulting	tư_vấn
cut	cắt
dead	chết
debt	nợ
equal	bằng
hunted	săn
hunts	săn
hurts	tổn_thương
lack	thiếu
launch	tung_ra
law	luật
lose	thất_bại
loyalty	trung_thành
macbook	macbook
macbookos	macbook
major	chủ_yếu
majorly chủ yếu	
marsh	
drawn	kiệt_sức
drop	rơi
dual	đôi
dull	nhàm_chán
saw	thấy
beachside	bờ_biển
resortvilla	khu_nghỉ_dưỡng
asia	châu_á
quility	chất_lượng
rest	còn_lại
visted	thăm_quan
street	đường_phố
mayhotel	khách_sạn
eveything	mọi_thứ
hoteldesartsaigon	khách_sạn_desarts_sài_gòn
hôteldesarts	khách_sạn_desarts_sài_gòn
faar	sợ
links	liên_kết
boss	sếp
everning	buổi_tối
afternoon	buổi_chiều
superyummie	rất_ngon
hanoi	hà_nội
nice	tốt
os	hệ_điều_hành
qaulity	chất_lượng
beaten	bị_đánh_bại
neighbouri	láng_giềng
heart	trái_tim
hurt	tổn_thương
crown	vương_miện
last	cuối_cùng
caddies	người_khuân_gậy
bouncy	sinh_động
awesomely	rất_tuyệt
cost	chi_phí
wedding	đám_cưới
trekings	đi_trekking
suport	hỗ_trợ
operator	nhân_viên_điều_hành
poolbar	quầy_bar_cạnh_hồ_bơi
chirping	hót_líu_lo
rundown	kiệt_sức
Cty outsource	công_ty_outsource
outsource	công_ty_outsource
some	một_số
spaciuos	rộng_rãi
staff	nhân_viên
best	tốt_nhất
stolen	ăn_cắp
facelifting	căng_da_mặt
haiphong	hải_phòng
supposed
landscpaes	phong_cảnh
silkpath	con_đường_tơ_lụa
coocking	nấu_ăn
experiences	kinh_nghiệm
standard	tiêu_chuẩn
exellent	xuất_sắc