aem	anh_em
cope	sao_chép
coppy	sao_chép
ctrai	con_trai
khôg	không
bme	bố_mẹ
cta	chúng_ta
mih	mình
mqh	mối_quan_hệ
cgai	con_gái
nhữg	những
mng	mọi_người
svtn	sinh_viên_tình_nguyện
qtam	quan_tâm
thươg	thương
qtâm	quan_tâm
chug	chung
trườg	trường
thoy	thôi
đki	đăng_ký
atsm	ảo_tưởng_sức_mạnh
ạk	ạ
vch	vãi_chưởng
cùg	cùng
pn	bạn
pjt	biết
thjk	thích
cuxgn	cũng
dduocj	được
nuoc	nước
keke	ce_ce
ktra	kiểm_tra
nek	nè
cgái	con_gái
nthe	như_thế
chúg	chúng
kái	cái
tìh	tình
phòg	phòng
lòg	lòng
từg	từng
rằg	rằng
sốg	sống
thuj	thôi
thuơng	thương
càg	càng
đky	đăng_ký
bằg	bằng
sviên	sinh_viên
ák	á
đág	đáng
nvay	như_vậy
nhjeu	nhiều
xg	xuống
zồi	rồi
trag	trang
zữ	dữ
atrai	anh_trai
kte	kinh_tế
độg	động
lmht	liên_minh_huyền_thoại
gắg	gắng
đzai	đẹp_trai
thgian	thời_gian
plz	pờ_ly
đồg	đồng
btrai	bạn_trai
nthê	như_thế
hìhì	hì_hì
vọg	vọng
hihe	hi_he
đôg	đông
răg	răng
thườg	thường
tcảm	tình_cảm
đứg	đứng
ksao	không_sao
dz	đẹp_trai
hjxhjx	hix_hix
cmày	chúng_mày
xuốg	xuống
nkư	như
lquan	liên_quan
tiếg	tiếng
hajz	hai
xih	xinh
hìh	hình
thàh	thành
ngke	nghe
dzậy	dậy
teencode	tin_cốt
tnào	thế_nào
tưởg	tưởng
ctrinh	chương_trình
phog	phong
hôg	không
zìa	gì
kũg	cũng
ntnao	như_thế_nào
trọg	trọng
nthế	như_thế
năg	năng
ngđó	người_đó
lquen	làm_quen
riêg	riêng
ngag	ngang
hêhê	hê_hê
bnhiu	bao_nhiêu
ngốk	ngốc
kậu	cậu
kqua	kết_quả
htrc	hôm_trước
địh	định
gđình	gia_đinh
giốg	giống
csống	cuộc_sống
xug	xùng
zùi	rồi
bnhiêu	bao_nhiêu
cbị	chuẩn_bị
kòn	còn
buôg	buông
csong	cuộc_sống
chàg	chàng
chăg	chăng
ngàh	ngành
llac	liên_lạc
nkưng	nhưng
nắg	nắng
tíh	tính
khoảg	khoảng
thík	thích
ngđo	người_đó
ngkhác	người_khác
thẳg	thẳng
kảm	cảm
dàh	dành
júp	giúp
lặg	lặng
vđê	vấn_đề
bbè	bạn_bè
bóg	bóng
dky	đăng_ký
dòg	dòng
uốg	uống
tyêu	tình_yêu
snvv	sinh_nhật_vui_vẻ
đthoại	điện_thoại
qhe	quan_hệ
cviec	công_việc
tượg	tượng
qà	quà
thjc	thích
nhưq	nhưng
cđời	cuộc_đời
bthường	bình_thường
zà	già
đáh	đánh
xloi	xin_lỗi
zám	dám
qtrọng	quan_trọng
bìh	bình
lzi	làm_gì
qhệ	quan_hệ
đhbkhn	đại_học_bách_khoa_hà_nội
hajzz	hai
kủa	của
lz	làm_gì
đhkhtn	đại_học_khoa_học_tự_nhiên
đóg	đóng
cka	cha
lgi	làm_gì
nvậy	như_vậy
qả	quả
đkiện	điều_kiện
nèk	nè
tlai	tương_lai
bsĩ	bác_sĩ
hkì	học_kỳ
đcsvn	đảng_cộng_sản_việt_nam
vde	vấn_đề
chta	chúng_ta
òy	rồi
ltinh	linh_tinh
ngyeu	người_yêu
đthoai	điện_thoại
snghĩ	suy_nghĩ
nặg	nặng
họk	học
dừg	dừng
hphúc	hạnh_phúc
hiha	hi_ha
wtâm	quan_tâm
thíck	thích
chuện	chuyện
lạh	lạnh
fây	phây
ntnày	như_thế_này
lúk	lúc
haj	hai
ngía	nghía
mớj	mới
hsơ	hồ_sơ
ctraj	con_trai
nyêu	người_yêu
điiiiiii	đi
rồii	rồi
c	chị
kih	kinh
kb	kết_bạn
hixxx	hích
dthương	dễ_thương
nhiềuuu	nhiều
ctrình	chương_trình
mìnk	mình
mjh	mình
ng	người
vc	vợ_chồng
uhm	ừm
thỳ	thì
nyc	người_yêu_cũ
tks	thanks
nàg	nàng
thôii	thôi
đjên	điên
bgái	bạn_gái
vớii	với
xink	xinh
hđộng	hành_động
đhọc	đại_học
mk	mình
bn	bạn
thik	thích
cj	chị
mn	mọi_người
nguoi	người
nógn	nóng
hok	không
ko	không
bik	biết
vs	với
cx	cũng
mik	mình
wtf	what_the_fuck
đc	được
cmt	comment
ck	chồng
chk	chồng
ngta	người_ta
gđ	gia_đình
oh	ồ
vk	vợ
ctác	công_tác
sg	sài_gòn
ae	anh_em
ah	à
ạh	ạ
rì	gì
vn	việt_nam
nhaa	nha
cũg	cũng
đag	đang
ơiii	ơi
hic	hích
ace	anh_chị_em
àk	à
uh	ừ
cmm	con_mẹ_mày
cmnr	con_mẹ_nó_rồi
ơiiii	ơi
hnay	hôm_nay
ukm	ừm
tq	trung_quốc
ctr	chương_trình
đii	đi
nch	nói_chuyện
trieu	triệu
hahah	ha_ha
nta	người_ta
ngèo	nghèo
kêh	kênh
ak	à
ad	quản_trị_viên
j	gì
ny	người_yêu
dc	được
qc	quảng_cáo
baoh	bao_giờ
zui	vui
zẻ	vẻ
tym	tim
aye	anh_yêu_em
eya	em_yêu_anh
fb	facebook
insta	instagram
z	vậy
thich	thích
vcl	vờ_cờ_lờ
đt	điện_thoại
acc	account
loz	lồn
lozz	lồn
trc	trước
chs	chẳng_hiểu_sao
đhs	đéo_hiểu_sao
qá	quá
ntn	như_thế_nào
wá	quá
zậy	vậy
zô	vô
ytb	youtube
vđ	vãi_đái
vchg	vãi_chưởng
sml	sấp_mặt_lờ
xl	xin_lỗi
cmn	con_mẹ_nó
face	facebook
hjhj	hi_hi
vv	vui_vẻ
ns	nói
iu	yêu
vcđ	vãi_cải_đái
in4	info
qq	quằn_què
sub	subcribe
kh	không
zạ	vậy
oy	rồi
jo	giờ
clmm	cái_lồn_mẹ_mày
bsvv	buổi_sáng_vui_vẻ
troai	trai
wa	quá
hjx	hix
e	em
ik	ý
ji	gì
ce	chị_em
lm	làm
đz	đẹp_giai
sr	sorry
ib	inbox
hoy	thôi
đbh	đéo_bao_giờ
k	không
vd	ví_dụ
a	anh
cũng z	cũng_vậy
z là	vậy_là
unf	unfriend
my fen	my_friend
fen	friend
cty	công_ty
on lai	online
u hai ba	u23
kô	không
đtqg	đội_tuyển_quốc_gia
hqua	hôm_qua
xog	xong
uh	ừ
uk	ừ
nhoé	nhé
biet	biết
quí	quý
stk	số_tài_khoản
hong kong	hồng_kông
đươc	được
nghành	ngành
nvqs	nghĩa_vụ_quân_sự
ngừoi	người
trog	trong
tgian	thời_gian
biêt	biết
fải	phải
nguời	người
tđn	thế_đéo_nào
bth	bình_thường
vcđ	vãi_cả_đái
tgdd	thế_giới_di_động
khg	không
nhưg	nhưng
thpt	trung_học_phổ_thông
thằg	thằng
đuợc	được
dc	được
đc	được
ah	à
àh	à
ku	cu
thým	thím
onl	online
zô	dô
zú	vú
cmnd	chứng_minh_nhân_dân
sđt	số_điện_thoại
klq	không_liên_quan
ks	khách_sạn
note	chú_ý
chill	rất_thư_giãn_và_dễ_chịu
terrable	chịu_đựng
kg	không
ko	không
hanoi	hà_nội
frienfs	những_người_bạn
tphcm	thành_phố_hồ_chí_minh
nhìu	nhiều
ship	giao_hàng
fody	ứng_dụng
tl	trả_lời
r	rồi
vs	với
trể	trễ
bh	bây_giờ
ntn	như_thế_này
ms	mới
mn	mọi_người
hnay	hôm_nay
zui	vui
nx	nhận_xét
view	phong_cảnh
hd	hóa_đơn
sp	sản_phẩm
shiper	người_giao_hàng
mội	mọi
duyet	duyệt
kcn	khu_công_nghiệp
tue	thứ_ba
hok	không
nua	nữa
hcmc	thành_phố_hồ_chí_minh
thamquan	tham_quan
snhat	sinh_nhật
kemn	kệ_mẹ_nó
ktra	kiểm_tra
TA	tiếng_anh
xịn	tốt
xịn xò	tốt